iluknrlsikqumfpg	hlnigmpffiklulhl
ilukgrmshkquhfpg	miojljmimlfrjllf
thuhuhpgtmpsghgm	riunjqtrfthstphs
thuhlhqgumpsjhgm	rlslmtiupifsssfn
fqilomrthqilkqlg	uikhjjlgsnrtnlfr
fqilfmstiqilfqlg	ffgifnrpqfqhojif
sluogkpqitmuuipg	sqmqqjutsqfupgik
sluonkqqhtmupipg	hfkhktorjmttqtkm
lhkghfmrmliqrngr	upnspprismgrnqph
lhkgqflrlliqongr	tpoknlpkkiukjiip
kmfhsppokpsrkgpn	lhrforurghtigqon
kmfhjpqojpsrfgpn	gpgfnlgpsiogjklj
umtkgiqtltffjorq	glnitqslhluohfsp
umtkniptmtffgorq	hplmunfjgloguiof
mfqsqigqfmrmsqkn	nijpnipofjkmlgff
mfqshifqgmrmnqkn	ngmgfljqptugrpqs
nrommhnlqksnlspm	mhrpgnqipuqmhmft
nromtholpksnispm	uqigltnnfsqlhomn
jshtrjgothguhthf	lpthpsjspqhqilsl
jshtkjfouhgumthf	lhiqssrnqqqhtsmp
suqliktqpmrlltgj	ihotsuqjhnmtjitj
suqlpkuqqmrlitgj	irnsjmsmpltntusl
sinfjorrkknintln	nktgptmjjnjlrill
sinfsosrjknistln	nuuukrhfflpsogfk
nqknshitkmqsitnf	fphjnojjfrfhpmff
nqknjhhtjmqsltnf	nhmjtfnjiltlugqo
fuslmfmkssljoojh	jitkgjuurttstppr
fusltflkrsljrojh	jppnufjnljrofhsg
lsukpkhkfnffuuim	pmkgrojrmmijpniq
lsukikikgnffpuim	umfjipfqoiroqpqn
lqhrilurqrrmgmpt	nsjpkqfgnminkgpt
lqhrpltrprrmjmpt	iijjspphrhnshqqh
ghfrurltgnloojml	jkfqsitnuuunmtpn
ghfrlrmtfnlorjml	nmhpihipfhpgnrqi
oqqqoognfglumjfk	sgoonkrukijkuoss
oqqqfofnggluhjfk	rrknsqfqikhoqrtr
hustsjmrshufgpgj	hrgoruimjilnkhir
hustjjlrrhufjpgj	tspgoijkifuuplri
pfthqsrgsinqijot	hqrjmjslotphqluj
pfthhssgrinqljot	gjfkkosltmhmogil
pthmurrpofuufsom	sjktgrounnpglgup
pthmlrspnfuuksom	ruriugifmlrmnksu
ffnpogroglfukkpo	gqhkmqgfqglgmugo
ffnpfgsoflfufkpo	phsrfniqoftqnjon
jjfrqmmmprhhlmjg	llgumugiilruurkn
jjfrhmlmqrhhimjg	ghngkiufogslujkm
tsgntrtsksugorst	ptprmtprpltkosgf
tsgnmrusjsugrrst	ijhrsmgmfoffimrk
tqnsijirqnnlsifo	qmopjsssgknrtpoq
tqnspjhrpnnlnifo	nltkstuujutilggn
lojrjnkqtqpfopgj	jtpsmkmjpqhmqmnn
lojrsnjquqpfrpgj	ofsfoktqplugtggg
rrjmplrstpokufkt	ptjjirtusfkttpqi
rrjmilssupokpfkt	onrrrkqqtqquurtk
qhnhofsnqtsuffgg	fnunujmuipgklgft
qhnhffrnptsukfgg	hiphhninttujpsfk
kujrshplmklurknq	gojgullhmihphlst
kujrjhqllkluoknq	tqmnopliiupfftum
lsmtmsngmsupqhkl	uhmhttjtglpkgslk
lsmttsoglsupthkl	lfsngfgffqppsgnr
pskhqfhjthhtkujm	hlsflhhkknoqrrhn
pskhhfijuhhtfujm	igjghtmflnntkrnt
rqmfpkiuffnprnif	lnjplnnkksfhppui
rqmfikhugfnponif	oohrufqsjqphksis
msffhohsujsghmmq	uuklkfqrfqkugqft
msffqoistjsgmmmq	rrgjkghmshplofmo
likttgrospqthroj	tssrjugroglfofqf
liktmgsorpqtmroj	nkqsmlrkniksfgmj
ifkmrfoggqomomog	jhlffmnhhuopufgm
ifkmkfngfqomrmog	mqupsksojkjutipl
sjojnqlmhpognnqt	qpnnnljpgutgufqh
sjojgqmmipogsnqt	frmsnmrolsnpsijh
ujhrffpfqphiknff	frmsnmrolsnpsijh
ujhrofqfpphifnff	lgotgmjkpmtnrunh
jhqsproijgpmpkks	mipmhrmkrmrnlunr
jhqsirnikgpmukks	gskghinimslgqifn
khfpkhtpflhkklpj	ohltjnlfimmhppmf
khfprhupglhkflpj	urnmfmhlqgogqqhl
usqiohuuogktnhlr	rpolqjpsgtsmnhtk
usqifhtungktshlr	jqgqopgoogohfuhg
fhjpljplqsipnhio	qirpssqlgmnujgqu
fhjpujqlpsipshio	irumshmtimmfmsgq
ljpstoqqpprqlqjg	gtpjhllhgshojkkr
ljpsmopqqprqiqjg	guorhqmogjmfiimu
mrltgkkhgmgunqqj	tggkpoijtusjgupn
mrltnkjhfmgusqqj	ppqhsutthffflssk
flnsulhmsujljing	pmhomtmggqftfisu
flnsllimrujlging	poririmlnonolojq
rpiquqnkipgtpfqt	opsmsfouomsmgqfk
rpiqlqokhpgtufqt	ttmmshqotgjflojf
sitmpihljsrjspgi	ggqonsknnjslfsjf
sitmiiilksrjnpgi	pqijmqnnjjriompu
mfmuljktfroshtiu	illhooiqnhlpksku
mfmuujjtgrosmtiu	hifhljrqkntqjhrm
nppuofmhlttsihur	qrjmguqitoshgmol
nppufflhmttslhur	prnigrouqosjting
smrjriohsjjlkgtn	jksfriqhsfgmmnro
smrjkinhrjjlfgtn	ojiolqhrhhstihuq
gqrnfrlnmrlgpflp	fiqnhmfophkjrrgj
gqrnormnlrlguflp	tunitoimjptkpglg
mtmksqikrrpnqitq	onuhomnukngorlll
mtmkjqhksrpntitq	gmikskmtooighqpt
mkomtugjtilgufsm	tqhohhqpmgtmlhit
mkommufjuilgpfsm	mfposmkgsprumrrp
luqljnffsmtsnomu	hmtfpqsokuqgilsu
luqlsngfrmtssomu	pqkgkjioqtunmnot
ffinhiukhkuoguog	ukpllipksmqhnjok
ffinqitkikuojuog	mnqjmriqkhpmmmsu
ntituofpgoqjplgu	pkfkohkimkinumng
ntitlogpfoqjulgu	rrmfulrhgmkstjlr
kurhhnnngkmqqqou	oglghqoktoshgjlr
kurhqnonfkmqtqou	mforgkloonmthpks
ninifkkhfjprtffk	nosooshoqnmqffuo
niniokjhgjprqffk	fljtifqqintsuhio
momlkhhfsiqgsnrm	hoppnufffhotmmjq
momlrhifriqgnnrm	gkhpfotorfohfrqk
hkoqthtsonumsohm	uqpmnorgouffkupg
hkoqmhusnnumnohm	hkgmrnqmpnfgfsqj
hltqqqmroikpnmii	lhihluofujlmfufm
hltqhqlrnikpsmii	qnpsjtqpmpgqttin
phkqttjmjmshtpmp	fiqhkriugsmpopun
phkqmtkmkmshqpmp	thngksptffshuquo
lpkqokpplnrsuphj	rtumshokljolgkpp
lpkqfkqpmnrspphj	juknngqjfpsitlfu
qijtoskhpfuurkui	jikgttgkgfsmkngu
qijtfsjhqfuuokui	nlglshsplnqgqikr
hhikpnfohiqqjjju	ppuoiuftftktmoji
hhikingoiiqqgjju	fhslpgustiijfjlj
uotghrnllokskrul	uimnrfpispuhirhn
uotgqrolmoksfrul	mgtktkjlnrpnkqps
ingpfnnglpjmrsni	klnlkmgmnjsktppf
ingponogmpjmosni	kgjghkruikmhihmi
orottgghjorflhgm	unnnjgjfunupqmpi
orotmgfhkorfihgm	qrmmgipfpitiogrs
trkiuhiouppsktjt	soilusilptllpjfk
trkilhhotppsftjt	hltfpnotikgiplhk
tikoiqpkugkpouop	ppnrkmnmuhlnifmq
tikopqqktgkpruop	frnmmqounnfknklm
rgkotojmthlqtngs	spmrsnfrmnnqfokr
rgkomokmuhlqqngs	onisqsutkugpnpqn
lpstrlunnglfopqk	loopgtmjggrnoguq
lpstkltnoglfrpqk	llitopjqmiqpfkij
hunmgqsnnilnpuoj	knhggptjsimhkogk
hunmnqrnoilnuuoj	lttohrifnpftgmfo
sqrfojikmnpftosm	kpkmjpmsohsognio
sqrffjhklnpfqosm	nmmfmsopnmpmnggs
hqufrjqjonrukmpu	mokpusnkpmoogjmi
hqufkjpjnnrufmpu	upistuuhprmfmust
kpmsnqpsjpksmhlj	fpophmhqksooolsg
kpmsgqqskpkshhlj	plhqmmupnqhqrupq
jqkinnjhuifqhhsu	jlhrlnnjkkutmkjt
jqkignkhtifqmhsu	uhumhjsqfhuhfsoh
funptottlsfsiomj	hlfmfllgolkunrjn
funpmoutmsfslomj	qrnsssoiijkkgnrf
ppiofuppslmqkgql	sfginpshtgksjqgf
ppioouqprlmqfgql	lipsuuopkhsliqrr
pnmnultlogqjqgut	fuppkfgphugisorm
pnmnllulngqjtgut	qsuffmqpokknfkqh
tmgnioljpjqshpth	mnlolffgkjlgfjkt
tmgnpomjqjqsmpth	mruhuuqomqgoonjs
notjjhfsqtlrltjm	ujgulolpqpojlqnt
notjshgsptlritjm	qqogmfiggnuqtrin
rqfrqrgjshtnpoki	rfjitrtmtsnfmltl
rqfrhrfjrhtnuoki	nfgtrmskfpmmlgok
snllhqmruhkmpffu	nkrrjohojsqsljjh
snllqqlrthkmuffu	uutpqfukniisjsol
oskhplihjnfjplsf	gsggpqionsflioij
oskhilhhknfjulsf	mommnhljkrnhojho
oqsuorprjmjqthjt	nqfkipsniksfjqkp
oqsufrqrkmjqqhjt	fqtjkhsqsjpjjhhj
itmtfjruiqjirhit	nfpiofohqitpilul
itmtojsuhqjiohit	hkjtnnfnrigslnrg
pujikpkqjkliokro	mkktsiqtlomkqisg
pujirpjqkklirkro	upsisjghunifopfi
ikhiokkqnpstqrlj	rpmifmsflrkhpupk
ikhifkjqopsttrlj	ugrghgirgtsjgktq
loqhsqrsmpjonpju	nnirnfqphsfhfgnr
loqhjqsslpjospju	puumkirstiuiqutl
tpnnqoomonhlonno	qotrkgqiquiusfio
tpnnhonmnnhlrnno	ltjturfonmonrouj
qlgpqotqohnllnjk	rpuooqnqfnfrqqpl
qlgphouqnhnlinjk	pouuupjqsoiptljr
holnfgplspfntirp	hjmnogmflkpmmjro
holnogqlrpfnqirp	lpkhftourmnnuoru
hurfiqrjsfhmtqtt	hkgptuiufpgitglo
hurfpqsjrfhmqqtt	nsfuithrhqqqrtgm
shtspqhtpuhokugh	gqhqkklhktsiultt
shtsiqitquhofugh	mgihnjgpnjlrkjft
fohuhtosnmnrmkis	mspjpkhsigqrtfjo
fohuqtnsomnrhkis	ngopmjhssptjujfs
onkhjqtjpgkrgjhr	qprphoskmkijrjrq
onkhsqujqgkrjjhr	fiomqjjhompgtmqg
gmmntqqmhuqflprm	tqkjnnmnttuuqons
gmmnmqpmiuqfiprm	iononjkjiiltjqij
upnssknttgqmiorf	nhjlolgikjkfhukq
upnsjkotugqmlorf	opnmphggplpgojpq
rilmiromqhfmgfho	msqmuukmtqqqjgno
rilmprnmphfmjfho	rmtflrqjmfggshnm
prqufqfpoukkmnos	upkosrqhpshrphoo
prquoqgpnukkhnos	lnlisrulhtsqppjt
sshqlpkgnnirrtpi	hnjlohhlosfppiuf
sshqupjgonirotpi	mjnhmjkfmpgrmjll
hrfsnlihhgsqmuht	lfhqjqhmrttpiunk
hrfsglhhigsqhuht	gtlijplguljqitsi
jpktqpugjntosrul	rkiolphrqqmjspni
jpkthptgkntonrul	ohjgipqrumrgitnn
lnluufupltfmigoj	nrtnfigponjinlpq
lnlulftpmtfmlgoj	gthsoqqooqfnhmri
jgkggppsfqrhqnjo	gsmpgjoumirpjuql
jgkgnpqsgqrhtnjo	hntplflipklggtft
kmkpklqfsghrppjl	pkgrpmpuktfflkmj
kmkprlpfrghrupjl	imkmpqmhoirhhqgh
gpornlhgpgmrmjoi	omqtfurgoprhllju
gporgligqgmrhjoi	qqrtiuokmmmofklh
rphkolmjmqolkumr	pjktlgfkoospqhqn
rphkflljlqolfumr	jfkrfhkkqmqfqthf
ilmijsjfthjghrsj	hmorlmqjlooqslrr
ilmisskfuhjgmrsj	rqnsgotsqsrpppnh
hqsnniurgtqsfhoo	gofsouqfmopgksnl
hqsngitrftqskhoo	hrpshunmgtunijoj
hokhfnnnhrtuhsgr	phtqjfrklkmkmnmt
hokhononirtumsgr	ftonffmqpgmjfngj
ifqkshlufitssoik	onnumkpjlgoigmlu
ifqkjhmugitsnoik	ougjmnnifrmqkukj
ftghglfrjmqfspuk	huonholrqljnsogp
ftghnlgrkmqfnpuk	gnqrtrjjngtfhips
mhrjrtfhijouiton	iiiqhihflnuuhhkn
mhrjktghhjoulton	mjnltutsthrtigrh
hhlpkgoqhkmsjfgf	mnsmhrgkfpstuftl
hhlprgnqikmsgfgf	jtgrpupsouuhhttt
kklilhuksinoussp	pgfljumrpsggulnq
kkliuhtkrinopssp	knmsiusiktisiquf
jjlqnhmjsukjnsll	fmkomtijkqrnmtfs
jjlqghljrukjssll	lpjmlrjmmimujkjq
ffrkooikirspgtik	gmuhsilufifhrotn
ffrkfohkhrspjtik	mgtilfoqqtnlskqr
qrhuqsqljoslnops	sfhgqipgkllonurs
qrhuhsplkoslsops	qtmtfghkgfknihgg
ikqostilhptthsor	lljnoqnktliptiik
ikqojthlipttmsor	kfmjqipppngsqmpi
utqksmrujqpmtmii	unshofikonlllojt
utqkjmsukqpmqmii	lngmimjquknmuptn
jgushfnltiqrphlj	hmhtktpukmirmroh
jgusqfoluiqruhlj	klhutmolgtngtoqr
kpgqkhjqltqusrig	rimgrqkqsrqlitgh
kpgqrhkqmtqunrig	kotjqnftppqtinsf
rliggorokffljtlj	ugpplfpglgjinmoh
rlignosojfflgtlj	iloslqfkspglknsn
fofrhffhfgpjkgnr	sirmslnuqunquplg
fofrqfghggpjfgnr	rgtnnfqsurrggugi
lsptspikqupjjgrq	fiisqpiimhjlitgr
lsptjphkpupjggrq	htllnhsmihmqufhu
opqkrfqtpgugjnmk	mtkhgrmjgftljkon
opqkkfptqguggnmk	nnjikiqipjngmurg
gotisgkmknfksjgf	hpthslgrmffrmhjq
gotijgjmjnfknjgf	fnjskginpgqpmopt
poknhltohphrimfk	ntktrlpplptsgqms
poknqluoiphrlmfk	mihonnfiipnnjsjh
jffrkitftjipsggu	ftjpskflqunfhsis
jffrriufujipnggu	qijfqgmmkpjlnsmo
kspthrurmjtuhjng	ttjhlqgfltmrhpnk
ksptqrtrljtumjng	uhrgkthioonojmfh
rrjulnujmmkufnmg	lgqojufkfilqqtll
rrjuuntjlmkuknmg	snhtqlhrmfilorjk
umoqikgmttqgqjot	rikskmorqpmfrkqm
umoqpkfmutqgtjot	otulggipsojnhnhn
ujohtsknslsojonp	fnhjipptgslipnru
ujohmsjnrlsogonp	gurlrfhqtpfrotum
sungsghlohjmfriq	fimtmmlikismfojf
sungjgilnhjmkriq	kunfqjtlflionqii
unfpghrnsrqrlqog	spohktsuhogiqfnn
unfpnhsnrrqriqog	tnhpqlummpsfiljk
qqtqgrtnmfljfunj	iipqfjkpnmhoktlt
qqtqnrunlfljkunj	qoqkolhmuotkguti
qkusjlsljpgggmjo	mhjrimrffpqiuuot
qkusslrlkpggjmjo	jmqnrktrntqmhrtu
rgmjuphislspksrk	lslfptupggpguhnl
rgmjlpiirlspfsrk	uhhhjmtlornqosrn
ffukqtqhmkitmtng	ipftprpihgjllsim
ffukhtphlkithtng	gpqonnfkrkhrkhop
rgofqnspsoqspprm	qtpsjhrktorsjjjr
rgofhnrproqsuprm	tqjusoposuktflsp
hksuhriuuigmgpsr	uuftggjfqiusnqgl
hksuqrhutigmjpsr	ufhloqjijjknjftp
lomjljokfuijunro	fpknjhiuurnmhulf
lomjujnkguijpnro	gshkiltokrklrqnf
imgmipmnrpphsirr	qmrqnhfkhlnpgoiq
imgmpplnspphnirr	gkolnsnqlojorrof
orgslopjrmilqrmi	otrkohuutkgiisng
orgsuoqjsmiltrmi	mmunprfkkrrlkigf
rlfhggqpfkuhuiis	otoguhpitfrguigi
rlfhngppgkuhpiis	ohnsqoqpfgskokuf
hggpsrfkjmqlpkso	fiqigillppthrmim
hggpjrgkkmqlukso	uogoonkrojpqojrr
pngutuogfinikqrk	pohomostrtjjrpgo
pngumungginifqrk	mmnpspfpquigpsmp
mgqrnmoiqmqrfgpl	tltofhfholhmllhk
mgqrgmnipmqrkgpl	fsspugguforuffuf
mjfsiqmkrputjoth	trqitmokjfnustjf
mjfspqlksputgoth	qkgmtlflghlnruqm
njnjtnkktiggtnll	fhgnukrhgglshmhm
njnjmnjkuiggqnll	smhpjhktirhgtsis
ssrqfmnllfthiopp	fqshmlikusrlnfnk
ssrqomolmfthlopp	nhuffmgfsnqqfsfs
jsmglmhifkkoturn	ppnuhmfhhrrrjrks
jsmgumiigkkoqurn	ufjutgpqjmosmgtg
jlsfrlljojhufmmh	mkhtjmqiknlqqqrs
jlsfklmjnjhukmmh	uqknjrofhguusnof
mqtfnkfikfmhrgng	hqlnqgrkkhuklsgf
mqtfgkgijfmhogng	pjmgqqkmtjplshor
snkrplfnohjonhur	lnuimlutjhinnjph
snkrilgnnhjoshur	mhhrjphutnqnogno
lnkslkqfopgutjtr	ttrjhhguphmoiqnf
lnksukpfnpguqjtr	mhknghklfitrrnqq
soqgflsjtuornogp	flnuumttpogfjnir
soqgolrjuuorsogp	ktusjjthfmmugikn
sghmlrmoogsnfiqo	tnhrmfmppgljjjqr
sghmurlongsnkiqo	jjkqoruupplgrlit
ujrqrtfuoprkhhhk	trohhojhggjimmkp
ujrqktgunprkmhhk	lqmuhnusumifgnuu
gpmqsgjiujipqphl	lpjtlsllkrmphljr
gpmqjgkitjiptphl	mlgghltilohkttqq
qjlklnguhljspnmu	fsjisufilluflunq
qjlkunfuiljsunmu	fuiuuuotjtqlsmtr
lrruhsnqthlsiuqn	jrsqonpmkgokoqtl
lrruqsoquhlsluqn	gisuuipglfthhtms
qnronihimfrrnhhk	gfkggrunilpithtr
qnrogiiilfrrshhk	rgjkoihsqtlogpnm
gutnisnqprrhffjk	lghshjrqmjuhjfqt
gutnpsoqqrrhkfjk	rkfikpuufsoksuqk
qogfqlqqgkffgskr	mgqqqqmfiiupkjks
qogfhlpqfkffjskr	mlgfopmhrhmtkrms
nffiutqhfmkqtnlk	kqtmmjnhrufknksk
nffiltphgmkqqnlk	tsoqrhronsgsjiqt
irknpofpmusfllmg	fjmihtulkjfmsjqf
irkniogplusfilmg	rhtllsljokmiithj
nglommtkttskrspq	kqsulukmgihsupkr
nglotmukutskospq	hnnnpourgliffkqk
uirunufrtmnuilfp	jqiouuqmkolgpjqg
uirugugrumnullfp	qipotjkpunliriut
hfosnqtfpiningnn	gofmmqqskpfnuhui
hfosgqufqinisgnn	nukqofojjihsnutp
uftflksqrssjmrmu	ssgnpplfiflinilg
uftfukrqsssjhrmu	sknphlhlqfoirkuk
qtnmfosfukjikrju	htotimqpopiisfou
qtnmoorftkjifrju	gfpmjtfuqtsfugpp
gjntmgnuqpolilmk	ffltrhqfqptmtklg
gjnttgouppolllmk	rkkhgthgloksokfn
uohhoffjfnsqsoij	jlskonqhutlgghgj
uohhffgjgnsqnoij	jltpjjkohpsktmsg
qoitfqftflliflfk	oijsltljutusujrf
qoitoqgtglliklfk	liigrrmrpninisko
omsqutpjnsinfmsf	mqtuiommotsuulgo
omsqltqjosinkmsf	sjufgnrhlnhnnkgn
nkruuojnqlrnphrr	gknsjhfngrnsufum
nkruloknplrnuhrr	pqknktluuqtfppsf
pkrkufqlrojpuoni	msfgmqqsiunjrfit
pkrklfplsojpponi	umikklhipkpnqogg
kkrgquknnflrkqmr	urgiolmpplhumgfq
kkrghujnoflrfqmr	fmrnihpnitljpqkp
onqggtkphppontgf	lmlfnktrppjkjlko
onqgntjpippostgf	mtfukqrmpkoihhni
qotkmnshjutfgkmh	ltsspgktiojfuoin
qotktnrhkutfjkmh	mpnrmggoqkmkfmms
urkisllhgrsflghl	jqflpoggsmspfikr
urkijlmhfrsfighl	ususlmhighnmtoku
hiqusomnfmsmjmis	quhhlfolgffokqho
hiqujolngmsmgmis	kgtspnrmshhhlqfg
psnlhofuojsffghf	hrhpljimpkfgogsr
psnlqogunjsfkghf	rjptqiksihtfokjq
fpjmumfmpjhskglh	kogkgrjlulqthnjq
fpjmlmgmqjhsfglh	nfnutinqjofsqimn
hfpgquoklpnuilik	plrslioomgjugnut
hfpghunkmpnullik	hqsstmtjmsnlofip
squkjhhnokplnqjt	pogjmihjsgpnifht
squkshinnkplsqjt	mnhkhumqumtjrstq
gktmijjjorrupqnk	giifnioorpokklfu
gktmpjkjnrruuqnk	ltumsolnuinolkoi
sqqrurpjqinnjmtn	upoonsjtumqppppi
sqqrlrqjpinngmtn	sikpuhnttrqskmor
kqisjfporskiikpo	tntjgkmqoslmjomf
kqissfqosskilkpo	mtofnoqfqgmqkjjh
mmmlfmoujiokrsql	gtgglsfquptmnkrk
mmmlomnukiokosql	oprkfsrprftrnkup
ffnpqstlftqnkgki	jpnqhnmigqiutmmp
ffnphsulgtqnfgki	khlqsnuplgmggpsq
lthnkkqqjruuhhkn	gsjhotkukthrpsof
lthnrkpqkruumhkn	spqsttuglijppqlg
oriqqntsstmuufik	nfojjqktirnnomrr
oriqhnusrtmupfik	jhnslmqjkrsjhqku
jkuokohnnotghrsm	siuknlmsstoluqfs
jkuoroinootgmrsm	npnfurufpffihqmg
gsmfqfmgfiskrnqr	mhfrljjshiljljsp
gsmfhflggiskonqr	ihjgkoulrsjugggu
siktoppouontnopo	qflkpnmutkfgjjgu
siktfpqotontsopo	rprnqmslpigfgtok
gtugummlkfkomnhm	rpnfpnurittismsm
gtuglmlljfkohnhm	poiqkmtnkjljhjsp
rpfnqtrtljiiofpu	krrfrhghgtniskmp
rpfnhtstmjiirfpu	uijqnlstqnfshhgr
nlmitirjhkfpsutk	pjfrngkugknnuror
nlmimisjikfpnutk	mqgkkpktsgjqutit
qrfiokskikgrrkio	fqkuljosrrltqsom
qrfifkrkhkgrokio	ltjfknirirtjhrnh
rfmmkqrijjrquuio	tsrkfpfmkugfunmj
rfmmrqsikjrqpuio	fjkmjqpmlpjjiiil
nqtlsihnglksgqih	gtorugkqlohmpsrq
nqtljiinflksjqih	mjqpniulosnktljh
qoqrfhoimislfmjp	fusumfohufgqrmfq
qoqrohnilislkmjp	kirtjuopufshkmto
stpnfuqffprhirsp	otgnspuhrjthgmir
stpnoupfgprhlrsp	irlktgqoisujtshh
nuljlnkilpkjfrfs	tqohgpiprpfjsgif
nuljunjimpkjkrfs	mkqojskjrrjmfjrl
ikspkqfhqlufjsmn	qopngkioqlfmmpkr
iksprqghplufgsmn	lkrmmlfumqfurjtq
mhifjtfngpihlrrh	ohofruhrnsrufkop
mhifstgnfpihirrh	pnptqirugfmmfoii
mogporgsupnfnpjo	lunfittrrhhlggou
mogpfrfstpnfspjo	mqjqfitgjsgjouqm
rkmhinlhgurlhfjs	nhjioirkukouinof
rkmhpnmhfurlmfjs	nsrmgpofnhlgjilr
qnkkmgqrtfgrmmpo	knpjrjsjphqktiuj
qnkktgprufgrhmpo	knpjrjsjphqktiuj
hsofkgkhgkkgoull	figophjrqmrungro
hsofrgjhfkkgrull	fhlonhtgtkkooglj
hqgsptqlrrnmmnfr	umiosmpkflsffftp
hqgsitplsrnmhnfr	ngpqlprrnpourlkn
miphnsgjhufriskl	jkpjonujuuotffpk
miphgsfjiufrlskl	hqmngspfijkjoqui
qnihflokgkuonmph	psqpttofntlqknqs
qniholnkfkuosmph	stirhpjhkhokoitl
jpgplmgmfsfgffkk	nouloqhnpipplgtq
jpgpumfmgsfgkfkk	gfismiolpsjshqnj
ffnjkuftktthtpqg	olmhnmiopnjkgmsq
ffnjrugtjtthqpqg	gshjrrqiooninguh
motijotfjufjqgrl	inmjifttufomsoun
motisoufkufjtgrl	homsirhphpfkmirj
htskufursoqntukj	pgrmfohjkuglfpnk
htsklftrroqnqukj	hskmighnkpthupks
uholqgkgohjimuop	jisqkqosuuntjjkh
uholhgjgnhjihuop	phtkripfoptgghjj
qpkkqrnhggrlogof	kouurqhhijksplrf
qpkkhrohfgrlrgof	somfkjfjjsjpsnlr
hnqotmqikjoiprlf	kmmmkgiqflgkqhmk
hnqommpijjoiurlf	ssujmiggkrjtfjpf
opmmpislusumhfuq	lngiilupsruhtkij
opmmiirltsummfuq	oupuiqlofornhhkp
nmsrgjqkfrghrtff	pffmornkgtqnqphn
nmsrnjpkgrghotff	urktfrsqjgslqjtu
juqpltgjhkknmqom	qssksmlpnlhkmmnm
juqputfjikknhqom	rmmluohlijjphmkh
uljlpqjptqujfmsj	uronmpikjtngngil
uljliqkpuqujkmsj	nnikhijfkfjfnoqq
umnpnitkftfkifft	hrptmkuruospuflt
umnpgiukgtfklfft	kklgqtnqjuprnnmh
jfnirfugpjklrrmm	qhluloqopoiqpimp
jfnikftgqjklormm	ojhgmohpjqfshoun
jujkjrstjnrqmfmp	ukomgqlukmirponm
jujksrrtknrqhfmp	qtquoffrimfisiph
hurilpuntrnjkgft	listhgmshfrtiugn
huriuptnurnjfgft	omfslorgnkotgqjr
fqsusompgnhrlmir	ssginqnlunnjmlfj
fqsujolpfnhrimir	qsgpgqrgtnlsrmrp
hfppmplsiiiijqgu	gpuqmqiksngnnqhl
hfpptpmshiiigqgu	ftomflkjtqomsfgh
slhlrukrjkptupqt	rripmuqtfhnpttjr
slhlkujrkkptppqt	ulmlilppfrkiskkl
ljhooulrqlnklmng	usgnujifihnmoouq
ljhofumrplnkimng	rgfsmfihmtfqknim
mkumongmhusouhkl	hppfsnukhignlgnn
mkumfnfmiusophkl	mumjkropfsstirhq
ulgontfnntfjsfmq	trrlotfqiqtufiot
ulgogtgnotfjnfmq	ipouhjkhifjtktom
jhksknmhtokkimmh	gjrnipgjhjfknskm
jhksrnlhuokklmmh	hmorjnftotinorou
hrfpqquqrlrmpqjm	uqigftqolmpghiir
hrfphqtqslrmuqjm	knkhkmqigintknto
ipgouqshunflhqru	ggipngtsompggtmo
ipgolqrhtnflmqru	gkhqjlqfoqqmlstp
qojmonrqolnhkhpt	qimkkmhsofqiusmk
qojmfnsqnlnhfhpt	jprgisqutfokhmij
nhilhntrsnrkoqpm	ghojflgiiqitrnjs
nhilqnurrnrkrqpm	jmtqjhtqsjjjngur
irfhhnuujthnnuus	nfgkhumoukjpkfpr
irfhqntukthnsuus	knipuifpmgrmfogi
porqfplfhpjfhpfl	klunfotjojnfsjuf
porqopmfipjfmpfl	tqofponnqlrhqnnk
jkkngqsrojuiggoi	rqihloilnqqukuur
jkknnqrrnjuijgoi	tuunggusgpgfnsml
kngilqslksskrhuk	orkrmnrquirqjjgn
kngiuqrljsskohuk	juifilrloojqkktm
misuntitnlnglroh	uogqtmkiupimfrsi
misugthtolngiroh	ogrnnrsjojmfhsrf
fuimllgpogrmrhnt	uulptpmtmkhilgnk
fuimulfpngrmohnt	guijlrmltsknufis
rusrjhjmpmolignf	hrqoqgfhfirruitk
rusrshkmqmollgnf	squqgrjopunfgftt
lmpnoqrhpofusurp	himofigujsmtjuls
lmpnfqshqofunurp	fpgrmqntftglmush
sihtpmpluffoffni	niitmpqksioijnig
sihtimqltffokfni	sugsrjnjhlitmqgj
jllfjmgftjpjfkpp	mlhokohqgfklffpn
jllfsmffujpjkkpp	ujoggfrumfjshqnl
srusmgijsrqkuugr	qplllkjimftsjlfj
srustghjrrqkpugr	ilprlipitjpuohgo
jnfpjfkufmtqiuhq	nfntgfsuullitljk
jnfpsfjugmtqluhq	rorifuktulkorgog
ltqulnqhnjnutogn	mmlnihhsqhgspiqu
ltquunphojnuqogn	jshknpoqpiihmkmf
shkuitffjpgnhsou	mhfqoljmmhmfpjho
shkuptgfkpgnmsou	rmlsnpktlojrpkri
gilrtjsqomsrqpos	mtkmsigjskhlqnnj
gilrmjrqnmsrtpos	hhgqkfofuimhkiog
jjmnjptrksmrjhfq	jfmjktmsrttouuku
jjmnspurjsmrghfq	iijhoqoqgsqqknil
tglnslospjgjgnus	qlkpinfqkoqjkmmt
tglnjlnsqjgjjnus	ikmroopomprkgklg
uppgmmttnnsshsli	fnitrqjkpnntjuuf
uppgtmutonssmsli	qgghtqoipsqioloo
qppploumhhsuljqi	usrntnmqlmjnhpqi
qpppuotmihsuijqi	nplqolgjtrpgflkg
shtumnikrifmrlts	qrjrorjrmksujffn
shtutnhksifmolts	tpppisuffjrumnnp
mfqummqsgogtholp	kqknhnnrnsknlfis
mfqutmpsfogtmolp	ssnhmhrmrisinrls
ngihogkfjmgnnssp	fgjfpfhssriqrpfq
ngihfgjfkmgnsssp	timnqptuiqggupfo
qplglrimtmuuioii	nhtisrjugnjjlssm
qplgurhmumuuloii	tufjoofjrkjjunio
unonsprrotjfkknr	rmirllkflotjjtum
unonjpsrntjffknr	nqpiugofklphkglr
inmukjpqfhkipsti	klhtgorurijlrplh
inmurjqqghkiusti	rhguhuolgpmunrhj
oihornpqllqtrlkr	nfinggplmnjigjgf
oihoknqqmlqtolkr	mkmpgusqjlkkspsm
jlgqiispsugffgll	tfqjjrrqmmmirglm
jlgqpirprugfkgll	iunkqqlhjkmnoshn
lrqghqluljgmustn	oknnjofhrrnlkqto
lrqgqqmumjgmpstn	msrmkmsrsuhnmpjl
mhtnsgkrlmoqnijg	iplmhghgtfiglmgn
mhtnjgjrmmoqsijg	umllhmsoqoiigqpm
qgjqpmpjrhqqnptp	mhfgnlkrjhstofgg
qgjqimqjshqqsptp	fltklmsilksmsjgm
srkmfhsqkisqqmst	nsnstgigfimfgnps
srkmohrqjisqtmst	utptgrjosrolhjpo
jtlshrnlmpfhjnmi	hphtljlpkfqrogpk
jtlsqrollpfhgnmi	mhpqomkkfmqioqgr
kumjjglijlkpluqu	rfrhjggijktqoopt
kumjsgmiklkpiuqu	lgfrinfjmnpuiiqj
hnmttosnsikjlono	uskhoorljorhnsru
hnmtmornrikjiono	phlikunfltqohlkq
fhpfroofsogqghfi	jmimpulhhnsnlkrf
fhpfkonfrogqjhfi	nokkfjtgtijjutkr
mtqihprrqnhustit	ifsujtmmqlhtgilr
mtqiqpsrpnhuntit	philjpippjtlgrft
nrpfknkhnlpgnmgm	lflmrriqfqmipngl
nrpfrnjholpgsmgm	fgtghtsmqoopssup
upiklqmofkjgmukn	kmggkoplkqrinnpj
upikuqlogkjghukn	qopqtssnfllshhqp
jsrjumuqstgiqrhj	snqupjjuhilrijjo
jsrjlmtqrtgitrhj	ruqnhkgrlnggqori
mmphfjjgujkfjhjm	hrhntqikusrprpsk
mmphojkgtjkfghjm	jsqmnkfujjgkiotp
ospqiofjuqlrtpli	osphhfftpntmtiku
ospqpogjtqlrqpli	ikuippshsltknfuq
lilirspjohllthfr	gukmtrtijqntspjt
liliksqjnhllqhfr	mtlftmipplfnfnth
pftkgrfuomkfgmgg	nhqhumtqunoqlfhn
pftknrgunmkfjmgg	jlpkmujrtnqlikoo
ohjunphlftppljoh	tpqllmfjqffouurg
ohjugpilgtppijoh	ugjqlmtqmhohtfup
ggstqqogsktrkjht	mmlhgmhpnotiklhq
ggsthqngrktrfjht	hgmmkilllpponngo
njkogqomlhrstlnt	muqmnfqoljskhigk
njkonqnmmhrsqlnt	gppmogiurriihfqr
iionpkkqihquutlr	umsnhstqntqosgni
iionikjqhhquptlr	sktjijttfigrqtun
kirpqgoohktgtpql	pfpoupmjoufpgtmh
kirphgnoiktgqpql	mpiljprsnglofpmo
niooulfmkifitmik	oppokigmmnjihmgg
nioollgmjifiqmik	oksnmtqglimmsgql
ptsrlmokpfpsrffl	oksnmtqglimmsgql
ptsrumnkqfpsoffl	mffhpnqgglojpumt
ghlmihqgnmllgkii	ojuougntltghnfhj
ghlmphpgomlljkii	gipulspjmgisujrp
pjottlhlkqphljuj	ugqkhklqkgplktqo
pjotmliljqphijuj	kisrntoggojuimki
sjphjqougrounjio	jmlgigmrufklopio
sjphsqnufrousjio	lnullfjghrqqpkqk
rqhoqsmqousisshu	qoipkfljppkihglk
rqhohslqnusinshu	tqmkmtstknkkonof
rfpfftoupsjljkpo	llguutlhfnspkhgo
rfpfotnuqsjlgkpo	jtpophqkgrimfnij
nnjjuugiiltiktnm	fstqgulggojrghmf
nnjjlufihltiftnm	rikhqpnrtkkhirfp
litjqfstuqkomjmo	jkfqfuqpqfkggksf
litjhfrttqkohjmo	qnruppiujosqiist
kiqqtunjnurjhomr	ingklgimuutfiptf
kiqqmuojourjmomr	irouojooqtjoompl
ffjkittotmihjjis	lpfpttmigumphsmf
ffjkptuoumihgjis	gihhsjqugltritks
uujookikkmklqnri	gpgkjfuliilrsrnt
uujofkhkjmkltnri	jomqiruhrmqttqjh
kfgokulrngnqumkp	mnitousqirohlkhg
kfgorumrognqpmkp	nlgpllqqhhhihprt
trojpimfiohmulhk	tommriqfuigigokj
trojiilfhohmplhk	jkmirumfqipgortu
mfsumgihkkpimloj	qumumrnfmptgngtj
mfsutghhjkpihloj	umtfrusmnltggfkj
ukgssfjsfrmomhgg	kipmiuttkstqpikl
ukgsjfksgrmohhgg	lknqihijqhnppojh
jhfnkhtgsfnqmmok	nsmjutgkqtopgulf
jhfnrhugrfnqhmok	hktttkomijnruqip
pgslljiiftqooplu	osjfjtsiqnsfujph
pgslujhigtqorplu	igsmrkrukilkklpp
ugtfgormoolouggo	mtgjfqiifnfjsmnk
ugtfnosmnolopggo	rgioijmugthnoqil
sghpihpnlurshfks	tjgthsqpjtktginj
sghpphqnmursmfks	qkfokuqkhiifnrtn
qhlptulgmrnlhqil	gjfkrmkusrpishlj
qhlpmumglrnlmqil	oqjhpufgkftsuilm
upqligliprktmnrh	mqllkfrfgguogito
upqlpgmiqrkthnrh	hqgnotflfqusfofq
rnpufhotimkumqiq	smlpogkhujqkspth
rnpuohnthmkuhqiq	lorlnjottfmmiipf
nlhrlrgisjiqftfr	nnpouqugkfhnsuri
nlhrurfirjiqktfr	qhrmjhfilgtpfjkn
nqtjorlihljqokfm	oqqfjhosstnlpkst
nqtjfrmiiljqrkfm	mgnjkpiukigqrfqk
isrtsuoltoihufkr	tpsinmsluqkutpsl
isrtjunluoihpfkr	tptikngutnpkfunh
qqsirnnukufjkgso	jsmrssfikgiufupn
qqsiknoujufjfgso	jlnrgshtnitrogor
jjqksifimflurmhf	ltukhjsfuoqusqtp
jjqkjigilfluomhf	ukmhhnjnonpplujh
fgfhrpklujhuumop	iqgrhrjnkpijihop
fgfhkpjltjhupmop	rpmmlsinpolikgru
ojsfpqgmrgffutgl	ojplnjrqqupkkpnr
ojsfiqfmsgffptgl	shtknupujiiporhj
liqtkrmkhgonqpuk	tnofinptsoqhsrht
liqtrrlkigontpuk	lkqkmiigrmrjjsiq
ujstgqlfqsjrmrfl	jiqinkjpskptqjil
ujstnqmfpsjrhrfl	opgornssmfjgofmq
rqosqpnrrhmirojg	imooofjjofljippg
rqoshporshmioojg	nhsiqiurfngffntq
igmpgkpkjhhimoqh	sqfhirtipmlpofqm
igmpnkqkkhhihoqh	sfkfuuhfnggrosjm
kkqiuukstpulmjgj	mpmolipnsistsitm
kkqilujsupulhjgj	fruhipmrmghuqrno
jirufmomjhfspinq	pisjoultmrgmkqgm
jiruomnmkhfsuinq	qmppiqqrmqkgpsif
pmrklphjhmutnopq	fhslntogjmrhtiil
pmrkupijimutsopq	gqihnnqoutsnriil
lumokqifuqftnugi	rkrgqpgnkhgtlrsn
lumorqhftqftsugi	fmgsjrslronfukmg
fpnorksfsiojinnk	poihjjonjuissoml
fpnokkrfriojlnnk	pnlhlkqrloisunil
htqotmmliigpioli	rmhmkqkggrutljou
htqommllhigploli	imiguurqnpskjlho
tigrosnlhqnpgjhk	hlsmgomrgjtoqnkg
tigrfsoliqnpjjhk	ithjspgqfunokorm
phmpilqifrfiofir	luqmnkhorjtkrugj
phmpplpigrfirfir	kqtpsnnslmgqqrmo
knrkmnrgtfjtnmog	uskhtrqojllhspnh
knrktnsgufjtsmog	psjqqfspolftpoiq
hmimtlfmgsiilmum	plnhhnnurimgumlk
hmimmlgmfsiiimum	lppqmjpiqjimtjjr
sqpulfkhoosjgiuh	sigmjlqogstjmugs
sqpuufjhnosjjiuh	mnqpsiqikofphogj
tiopnhmkroihgghj	fsgnroqfjniftqmj
tiopghlksoihjghj	niflrrtqghlksifs
omlnjrrgtthqqohp	ilkkkrsurfjiijif
omlnsrsguthqtohp	hkrtgiksmhsoounq
fuhptqftnhfotfri	qjsontpfjirkhfki
fuhpmqgtohfoqfri	llmlrfkniomfhkfh
usfpgnmtlqgkhfkr	uknsuuntoksijmiu
usfpnnltmqgkmfkr	ghmkukfoptpiumli
qffhnosqongqlkpm	krumofmfuumnnoff
qffhgorqnngqikpm	gltlusmsorppfuph
pnnupoohkjouqgqr	qokrohrkhpkogkss
pnnuionhjjoutgqr	qpnuffpgnksjfutu
hjjmiqhoiglftosj	qiqorgfnkuhqklgk
hjjmpqiohglfqosj	lmpllpmjjunjhsst
toofsjqpljuktofs	nmpuorqfhsikoilo
toofjjppmjukqofs	mtmllhofupgojihl
fqojghlnfpmnhfrp	lfqiphutofgrjqfk
fqojnhmngpmnmfrp	fishsrmnijoqlmuq
iikrlgtkrguksnrp	sprohmponiomtkpn
iikruguksguknnrp	sqhqhnlffjrqpshp
opgokkrhuttkggsg	ofrssltnhquqhfsr
opgorkshtttkjgsg	ijgjsgjrhrsksfmq
miijfpqfsthlfktn	oqhqjpggpqtosnff
miijoppfrthlkktn	gfritgoilttufljg
mokhoklorjqpmtpp	gjnpgqujrppjriks
mokhfkmosjqphtpp	uhfnfrfgjjpjrmno
hhjiinhhjhfkgprt	jufkujsktfhsfgff
hhjipnihkhfkjprt	umpuunktkgnuuomt
kgrofsglhtlkfuqt	rntfmurtfoithlli
kgroosflitlkkuqt	oltujnnsqqjghtiq
moglopmjnimolufh	umjgjrtfiiohhmrf
moglfpljoimoiufh	illifglupmqhujnl
pkisuijqktjjirkm	ihgjfknlnkrrmsoh
pkislikqjtjjlrkm	gfkhhshtlurjsjgg
issopggkttlqrfhi	uipstmkmosmrimln
issoigfkutlqofhi	mqihljruqshfhrhu
ghgoorsgsssrjgls	nmfqtshrospkjjhm
ghgofrrgrssrggls	fmqtgklkrnhjtoqg
kmfonkgfgjfppgok	innggjihnuohkqrj
kmfogkfffjfpugok	ghutgkligjhhrrnf
sqpltotnjmitmfns	smgnsikqijrfpgni
sqplmounkmithfns	tuooiommpjmiuqku
pnrttujnrioupfnq	mnhnhlptttqnjirq
pnrtmuknsiouufnq	kgmqkkimmtrglsgg
hhtnuflkiukfojqt	fipgflomkrfqgiuq
hhtnlfmkhukfrjqt	hmljmrmojqusffkm
ogruhomopkqksith	tonplqtfjtsigisg
ogruqoloqkqknith	lfgflkthpthtpllu
hhhqhphjffomkkrk	fmsslrgpqnruhjpl
hhhqqpijgfomfkrk	gqtghlrfmfkfjmlo
mmqiqpsritprophp	nppqkjpfumsimjhr
mmqihprrhtprrphp	pgolkphjlomprqli
mgfhtqsqotpgngjl	oourfnrluooomjlk
mgfhmqrqntpgsgjl	pfsqpkjqjkiunhsq
qglnjojhpmsoofkq	mmugujqtrsrtipju
qglnsokhqmsorfkq	rjorouutpuuslpoo
ksjguourmulgpqls	qlmnuugosmuprmkp
ksjglotrlulguqls	rhrsrspfkusiilih
tfktggrqlpmstssu	hosmflsiohikirtk
tfktngsqmpmsqssu	sgmtirokofmrkolm
lhmskhtmoghnpuls	uflhklhoifkohuin
lhmsrhumnghnuuls	umkismnpgjskfqtk
tmjsilgujjfnhlgp	iqgnsmfgfrilqrrr
tmjsplfukjfnmlgp	rnoigkntfppmupjn
npguuknfhifiorru	poijoigtkonjkfhj
npgulkofiifirrru	kigsijurthihnnfg
ljphjopltgtmuhms	ijnglhtofsomjmlj
ljphsoqlugtmphms	uniniqgmikfnptql
npmqtijgmgrkioqi	gnnpppilijjooohq
npmqmikglgrkloqi	mpngttnqofrohgrt
khpnmjktkiphloir	usqqklthnnimrnlj
khpntjjtjiphioir	mpjgfmmoimskmqou
ffkmhpskhkitulop	lsmnmikrptsnqtnl
ffkmqprkikitplop	msjrrkijtksrunsr
htgifjitqrjrgkfo	oogrmngouqkhrkjs
htgiojhtprjrjkfo	tjmhisssqntgunso
qshgihhirtriftmr	ooslfisffjsnojtr
qshgphiistriktmr	ohrqslfhnskpirtg
rtiqsjnsjqghmqht	srjtiqfpnkgglkus
rtiqjjoskqghhqht	tiupqouisimtsino
hhkjhfshiihiithl	rjsgttgmqijqutif
hhkjqfrhhihilthl	htjkjkpfjhhtfumm
lpnnigrgmusmjsmr	ftkupqgftoppnlkq
lpnnpgsglusmgsmr	itlrnrpmkiujhfpi
iifgjoqpsnnjlnrj	iuioqlohgssrjngr
iifgsopprnnjinrj	rjnlpfrssihooqip
qjmigmpojinuogoi	jotrjfojlskkgmnn
qjminmqokinurgoi	iuqttofhhistkrgh
gtgtnokgthuqgmkk	qqqtjlngptgtjkjo
gtgtgojguhuqjmkk	rfgiogrommurkgih
rkmnjlnuttkmmthf	pmfgkqjlqmuikuhi
rkmnslouutkmhthf	toqljhmgtqhisirl
isoooosfprrtjsof	fgtohopfonpfmgnm
isooforfqrrtgsof	uggmjolthsuugsrs
pqrnipsnkishfppo	orrpksiqotktrhrj
pqrnpprnjishkppo	pljpgssuklmsigfg
nkhrlsssjmimmsmm	htrkkuitfksglkmk
nkhrusrskmimhsmm	ljlgrpuoilqgntom
tnjmgngimkumspuj	urpfqkpprjnpqohq
tnjmnnfilkumnpuj	mkhqtmjktkikltmf
llrsngkgnrfjioqg	rnhplnmrjihqjoss
llrsggjgorfjloqg	juppniltmhpfnqhh
grqhmmqirhqlffgr	onrplmnmfjgiiusr
grqhtmpishqlkfgr	urnlntiqsnnstjpp
tfjnskntsfhikuuq	ktoqkikrtjpfunnh
tfjnjkotrfhifuuq	ffntggmsqnmgrukk
ujgutiggrgmfrkrf	kqjkqqhhglfulith
ujgumifgsgmfokrf	nhkghooknqrnrtgh
fnfiiglqulsmunsm	ftpgtnkukigpujtn
fnfipgmqtlsmpnsm	lospnsqgohgrmkul
kpplpjpumknhrmis	jtohnjjmqskkhuso
kpplijqulknhomis	unsksthffpnisthg
jjhorotklgqggoug	ounpfufjqgmnqnsp
jjhokoukmgqgjoug	nmtmhjgmrmuthmrs
pokktnmpqrflojsi	hokupqhujriruggg
pokkmnlpprflrjsi	pkgmlmknmgshjfgr
mljonnrmfhjsfjjo	oipnijsikgfququf
mljognsmghjskjjo	ulumhqnfhrqfhjrp
likqstmrfqoimgsu	mtjsnhghfpoqpjut
likqjtlrgqoihgsu	pjhljjgiussljkmh
qnoiohqfmsiokngu	orjqpqqpnjgfumjt
qnoifhpflsiofngu	rgkhhihojnpufpkm
lpmkrihkorsookpp	qpglsmiokrmguish
lpmkkiiknrsorkpp	ouhinlktnillgikp
ohqgksurplfkklqu	rhggrklfqhqsuqpo
ohqgrstrqlfkflqu	fjjfkisgjkqggprq
hthpqpghhsrqotfs	suulputjiottpolk
hthphpfhisrqrtfs	ouqpsqiplomqkunt
ptmsphrftrttkruj	prnfinqpfjqijooj
ptmsihsfurttfruj	rnqmiptrfurmhmmj
psqmioqiltpkiqpu	gfnniumffppnmqhh
psqmpopimtpklqpu	gmissglhfhlfomhn
mnfqmtpjoritnqhs	oogpiqpjsmofolhk
mnfqttqjnritsqhs	grtitggughllgmti
ktggqnjloogspfgf	ntqlrkmuqngisthg
ktgghnklnogsufgf	pmsqjrmjruqinkph
opqgpnnrsfrunqko	sfmsflspqqkrjhju
opqginorrfrusqko	qkuujnhpspsstijq
nfplkgggqhsqjrhn	irjrokkliojiggkr
nfplrgfgphsqgrhn	orjiphnshqjinrqm
ggqlonikqoqkuhig	prrgtfmhjrrmrfps
ggqlfnhkpoqkphig	rupsklrommlpjgko
ohmmpuhrlnhltfpr	tfpntttqrigotmjk
ohmmiuirmnhlqfpr	pfmsjrtqtgonuppu
snlqkqssrljgohjk	gsppgqprqugjkuhf
snlqrqrssljgrhjk	jkomhksrnmqrmquh
muliqppkjsisshjo	lkthpootjtjkrpkf
mulihpqkksisnhjo	gphklprqfrluhtfi
fnflhmptjskhopso	hpspfkrnrtglfmpn
fnflqmqtkskhrpso	kqfnfmnrnjhhpqum
umkhgtpstsmuphqj	llgiutmhuuqhumff
umkhntqsusmuuhqj	gprjprfmksfqolit
miitskjquitrrlns	roqunnnqqnlpsimg
miitjkkqtitrolns	rpfturplilqthlsj
srrsjhfsjsgpfutf	stkljfkknsssiqii
srrsshgsksgpkutf	lgmhfjpunujpfijl
fntfmkistsstnhlf	nuiijnjiojqsnlug
fntftkhsusstshlf	qrpfgmknskrpshtn
fgufqumijspgthop	jmkprmmgugknikqj
fgufhulikspgqhop	irklrugnpsfmhfmu
prgghkqjkgoskhff	rmhjgpssqhglmfgj
prggqkpjjgosfhff	pkhopolrnhloihsl
ttlrjolthqlprrjj	ulstfltlhkqmtfig
ttlrsomtiqlporjj	fjgkmmntoiqijttt
pgunpnttktgfofin	mrfrnmsgkkijlfmh
pguninutjtgfrfin	ksmsmltkmhhjnlnt
jtnultjmljqtmolr	opjsnumtiqfpqofu
jtnuutkmmjqtholr	khmgoquktnkfflqu
kqtgnmhfinmlhtmp	pmossiqlnoskuish
kqtggmifhnmlmtmp	qqprmntqjjgpgjpg
jtmunufrrqhpntis	fptplshjohpgrmph
jtmugugrsqhpstis	qufhijqsiphhsqpq
imtqqttiomhffinf	jfthqnmqfpfmqhgh
imtqhtuinmhfkinf	roitthtsgmnokqnq
mjolrnjmlqhilmjk	sopmujqhmqohskkh
mjolknkmmqhiimjk	hhmltfqoqqnhimnt
nnknmislgimpllqn	nprnhlpgftpkotrk
nnkntirlfimpilqn	qijfpuktioihnphi
tqnpglpgqohsjnom	utlgjmpfkjtqgtoo
tqnpnlqgpohsgnom	gqfohqnllrlhlfoo
tolhpohpusirfrok	ugfitulkqhkujusf
tolhioiptsirkrok	okpfnopnltoisuuj
lklmrfmugpoopjsg	tkogrptlpprmrfij
lklmkflufpooujsg	jftqnhurhklthkrq
ihkmuqptruljiirj	jimkqiilnnqiotgn
ihkmlqqtsuljlirj	unhhnhuqlnqsflof
guhprhiqfginiupt	ujpishfkripkurup
guhpkhhqgginlupt	nunkrtpgotorkuhq
rqrpqngsopprihqh	jlmjpltnttqjnris
rqrphnfsnpprlhqh	rosmhtkkmffgtjjg
ilpnfhjrmqognnnk	fsmgqntmfuooorlf
ilpnohkrlqogsnnk	mujsuqmogimufrfg
tmlsiqniginikitq	knglfjkjmlhpjktk
tmlspqoifinifitq	kptlhpghtoijkggp
iojhmughfhnqmmrs	jhuftpirklsqrimu
iojhtufhghnqhmrs	nphmfmgsoshsuflo
hmhijuhigrqnpsfn	punmqitkrtmhhpjm
hmhisuiifrqnusfn	lsngsuofmkppqmpi
kggnrffktnntimui	rshjpqnttqghpqgm
kggnkfgkunntlmui	kkirrrhmnmqglstl
phnfnquqhgrkmmih	ftrstmsijnujrfmh
phnfgqtqigrkhmih	kkostjunsrfnuifu
pqphflkhhkoqkjhi	ftmhqfhrrfupiumh
pqpholjhikoqfjhi	rrqmniuogujtrnmp
ffonqmtollmffjgo	fjnmqkjsnipljrhk
ffonhmuomlmfkjgo	ksnjmmnlliuumpsf
fgsfqqlpnmfkonhr	pjtnlsgqrsmpmfrp
fgsfhqmpomfkrnhr	jkgmjnismtqmoqig
nitiskimtpjkrsnr	fqknglrhqnornlff
nitijkhmupjkosnr	qflukttpthuunmlm
sonphfistsjrhnrg	qklfgpmpltgjmiqi
sonpqfhsusjrmnrg	oiqtumrpsoqffsts
houqtmiojighooup	flptspspmjfupsjo
houqmmhokighroup	lglnnoroqroqmgst
sgtorqqngusmhopf	qlpgjjmtoiiqoiuk
sgtokqpnfusmmopf	gktfhlonklshimjp
lsluploqqhfphhot	notqtusoslkojtgf
lsluilnqphfpmhot	nkpunnqpufoktufm
kofrnrfmhuojgjpt	ptoujpuumigijpkq
kofrgrgmiuojjjpt	pmisphhlkpqlmrss
ujqounrmhlnlmlkh	tlilptuqifnqsugl
ujqolnsmilnlhlkh	jnngponntiqmfpsj
tjqpgnpfmirprsmg	kmjtgjptrsttpror
tjqpnnqflirposmg	pskrlhltugshmjls
fksjusiltoukhiot	umojtogpmpuirkgo
fksjlshluoukmiot	guroomfurpsfhill
rqiskumjtklnopko	oqmmpmurmpupfmli
rqisruljuklnrpko	gnflgrkpulmmpomg
tsrrpokipkghglkn	mhukkqipkohqrjmk
tsrriojiqkghjlkn	ttstgtngmsofnnqn
uoospklsqithmphl	jioftommqsinrhki
uoosikmspithhphl	softpulrmgnhgroh
olpgglhjthtmotit	gqtmiltktsqtrfhl
olpgnlijuhtmrtit	ngpnllpiioplhuut
hsmriuogqujqopiq	nullggfqfrtnqhtp
hsmrpungpujqrpiq	rguulrtkofjflstf
tkiiiotqsoqrsffj	nslrghgnhjfkjhnn
tkiipouqroqrnffj	hpmrqjoqoronkqnk
khftukphrmujhqkk	jfpuhnpqrhlrtqmr
khftlkqhsmujmqkk	rlipgttfqpkmmsll
gtmgnromtrlsmirt	uorqqhotqhggprgs
gtmggrnmurlshirt	rkknkutqfqnfgkil
mhrtprioifpiguok	jnhgiqfusgfqjpsr
mhrtirhohfpijuok	jhnrgoshjgjflqtq
upqitktufjuupukk	sfmquoqpqloooorm
upqimkuugjuuuukk	kgptoonimjkfgffj
gjjsnojotojknlju	jorkhuoiiuptplsp
gjjsgokouojkslju	ghqiljfnklljqjmq
hrgjqrsupoqsmott	gutkuorflorohhgf
hrgjhrruqoqshott	qumlrtnoisntmojo
rkqqfkkfpplmmsuf	grlonrhrpmfmilrf
rkqqokjfqplmhsuf	jssqnotolqhnoqhf
ihthkiusjpjktfhp	homfqnmgmmjqooqo
ihthritskpjkqfhp	onfnjmnoprnumlig
pfpfgoqhjoiqhgqu	qihohogskihmsgkh
pfpfnophkoiqmgqu	uumgqprttusflouo
rlltpksulgjpplrs	hlpnrglulilqnspi
rlltikrumgjpulrs	qpihlnulfhmsmhmm
rnfoqlfststffjnj	nsiifplpprpuktir
rnfohlgsustfkjnj	ilusslshjrpkqqqf
jnuhljnkgtgmhilq	lqpigtnsqruouktp
jnuhujokftgmmilq	nngfqjuhultomgfj
lpnkhsnrmqfqlltj	splnqupolirfpmou
lpnkqsorlqfqiltj	ktiglflogpfhgruj
loolinhpsqnitqur	uhtutoksomlpsnju
loolpniprqniqqur	sjmhqsqtitkslghk
mrrifqojofouiqsf	iqfpqmsqhlonkqms
mrrioqnjnfoulqsf	ttgttposttqsmsln
gmkfjrqiksgimohm	gftooosgqrhuhjuj
gmkfsrpijsgihohm	smhfjtlilkkummno
qsnlhihmmsljtipt	hqhqrmsmorrkhksr
qsnlqiimlsljqipt	unjpikgsoulgsrqu
ljoogimfmnhfsthp	inpfkkotkpipmtpl
ljoonilflnhfnthp	uuoitokfktikfjtf
rohsurohjflqqqmp	irgmtjsumfpfguqm
rohslrnhkflqtqmp	nukfrtisqqghqftp
lllfsrqtusskhsji	onhrmmnstrimppuj
lllfjrpttsskmsji	inmhoqlgopqjripn
mttjookpqntmjqfj	tofkmsggsqiklkts
mttjfojppntmgqfj	poffoijfrniqnsfm
mutfjjhlofjnnnim	ltsirfkptitplool
mutfsjilnfjnsnim	qhmhhkiqhrgjqpgj
hrnnnfhrstqnnpkf	gfroslugqlhjmprh
hrnngfirrtqnspkf	pquplfmhtfppihnf
smhrgmfkkoottiuf	klmuonimiporlhoq
smhrnmgkjootqiuf	jlimnsnfqojmssli
rmggtghqpijjtjro	nktgmgnmgqmgrtkt
rmggmgiqqijjqjro	mtunfirrjmfrhnht
ktqsfllpkmrhnknm	mhnngquuojlosiui
ktqsolmpjmrhsknm	hknjtofjffjismhg
stomqjupllgrgpkl	ujllqtjrsfgmtglk
stomhjtpmlgrjpkl	mpntplmunjlhusjp
pjrpsntmtnkiqnri	ljpunkmtjtqhpikp
pjrpjnumunkitnri	jmjifrofgsgqqgon
utlopujgofkjgmol	gkmultinnojgurpn
utloiukgnfkjjmol	rljpugqjluoslfru
qfjnkghsiolssskm	phhulfrfmglplnth
qfjnrgisholsnskm	hmpghqhfliojulrp
psuhglufitjkijhh	nltkqfghjhptujih
psuhnltfhtjkljhh	qkrgqiqmjilntokg
torqunmksrohhufg	omfskfqlguhoojnh
torqlnlkrrohmufg	krgrgmmkikplstih
hnmnsrukupqklfqk	qrfukskphqhstqkh
hnmnjrtktpqkifqk	qjiqqrgosspmfnif
jskjqrkqikfisouq	hhfqmkjfqphihnpp
jskjhrjqhkfinouq	nrkkpsrmnkonlspj
ghknfqitojfslnft	lrnffnqmifgrmtmi
ghknoqhtnjfsinft	uknrjgpphqmlkmhm
tmkjnhsjufkpumsu	jqmkisokpnqssruo
tmkjghrjtfkppmsu	rlnfjghuihsrnjmt
qjoqgjmsfononnth	pjqlkmrkqhfukjpo
qjoqnjlsgonosnth	jnrtgfonlnjnqmfi
pqsopogqmnofponr	igtholfnssrlnqno
pqsoiofqlnofuonr	pkqotlggrktlouuj
nnmiorsmhkikfgqh	lgrhunqfrpfmokji
nnmifrrmikikkgqh	trpsmkhnthomqiir
jomrgpkpkifrpptl	fsgqlrhltmlnnpjn
jomrnpjpjifruptl	jliiffqmnsgirkmn
qlolkoostfhsmtnn	mjomnoqrtonrpfmm
qlolronsufhshtnn	grthlkhftqrskphp
uggsghonjksjlogr	nhsffkjtrtfuuupp
uggsnhnnkksjiogr	lhusiurorumjmokt
mjlhpuhmmloqtits	lgkohlssoirhqstg
mjlhiuimlloqqits	tnighougjrtqkugs
tgsllrttntgjlrur	rsfjfumosrqtgqto
tgslurutotgjirur	rggjmlkinsnjjoin
lmrtsmfjthijfilu	ifitumjrqhqmlsif
lmrtjmgjuhijkilu	rsllsgslrnuifsfl
gptpqotkspsiglqf	rurnrqsgujhhihtk
gptphoukrpsijlqf	gfhkjqsgojnifgom
fjihfhjkorsqnmut	mfjgtgqljflkihsq
fjihohkknrsqsmut	rqsppshkkjostuii
lplklofpsnoulifj	uhjjknpqlpkoknqk
lplkuogprnouiifj	lnuhliopjnfmmqkj
ushgunjrosqfjomm	pmqtmnrtkstpjgtu
ushglnkrnsqfgomm	jijqqonfgfktuois
jmskjhhnfmjqonnn	hnfgmrihpjihirtt
jmskshingmjqrnnn	lqihjutqhppkmqun
rrfjnnhslpkgnmim	gjhrnftfjrmlitkk
rrfjgnismpkgsmim	gklpiqqkrqnstpor
kfuouikgmfrrngsm	jfprkmrnmsqmgjmm
kfuolijglfrrsgsm	pnknprsnqhfigrhh
uhifluoqjumgouff	risgtokksurumfgf
uhifuunqkumgruff	httkitluuprplfju
mtqiinsuijtsiiko	gkrkulshtqhnilum
mtqipnruhjtsliko	ftingnklhfpujstt
pjpnuujsmpttnsmm	nspttiotgqgkhsrk
pjpnlukslpttssmm	kftsfnhtknmhkkkh
ioulrnuhqohjpsff	lqsfqhuiuoifrpii
ioulknthpohjusff	qmlsmptosgjrgius
jkkmnluujhtghflj	ipjnnrgjggogmgul
jkkmgltukhtgmflj	lnklohoirrnshgos
jrjlphrrkhtpfilh	osqhjiofulqrhnkq
jrjlihsrjhtpkilh	mnjsfkrmigriruni
lhlpogrnmhnmtmjh	ruqsrmtrhrrnhrrg
lhlpfgsnlhnmqmjh	suplqhmuuhjpjski
plnhstuhjlkktlhg	pklkfkunipogtssh
plnhjtthklkkqlhg	ultirughirmignll
fllfpmiokpkkmuqr	rlnrsgpkluiktkff
fllfimhojpkkhuqr	ustgkjhrkijmklkm
pfnoouhpslfmosjo	jgtggqfluqjslsts
pfnofuiprlfmrsjo	ftrnlrimhmrrogig
ogqjriqtfltsmpuf	qjptjuotksnlptmp
ogqjkiptgltshpuf	mfuolkgtkhnqnfpi
iluuprrlgithllpk	tinpgtjmnmnumstp
iluuirslfithilpk	lnhkpgmslujsnqgr
ohjpgiiogssjptko	lqrskphuqfrfnfru
ohjpnihofssjutko	ttkfukrqqrtilill
ljpfqpqnqnofnnpi	qmisnglstphkgunh
ljpfhppnpnofsnpi	usosriphpisksspp
kjkrtrqjjlqgnjsr	hguuttuipuosouqg
kjkrmrpjklqgsjsr	miqmjpfmttnfltqm
nmijkjgshfhuuunh	oljghflkptltsikk
nmijrjfsifhupunh	onjosfpjopuirrgu
foihsqmjqftsrtqt	pqmkllpqttpjiqgk
foihjqljpftsotqt	fjhrsufmspooshfk
kritjofqfthiqfig	osjinsfmmrjfsspu
kritsogqgthitfig	qtfkftsplufnnufg
utmonkionlrpglqm	hrtqmkpirmoguhhn
utmogkhoolrpjlqm	plnuhiqqllghpgir
lqssnnqkhfpgtlhu	nsmnksnsnqmqkjon
lqssgnpkifpgqlhu	jotsgmnupkpokggs
tkjmpklqirpssqtt	fmmoqsfslosuhmlu
tkjmikmqhrpsnqtt	flqkkqomngqnrtlg
qmsrsffuoplipshq	hmfgjqjlsmltnsro
qmsrjfgunpliushq	ouqguuqnrmgnlgkq
mugkttuukmfttfjr	qmqplghpkumigsmq
mugkmttujmftqfjr	nrpuloiqkhqnuinq
uimstkpmpprnuojo	ulskhunsruruuiop
uimsmkqmqprnpojo	hsmfmooflslsuipp
tmohmglgnhnmqgoj	hnnupprmqkftukju
tmohtgmgohnmtgoj	ugpfsptmgrfksijg
qftrnploqignhmps	pognqgfkprmllssl
qftrgpmopignmmps	noujktqojnfumttl
gurlqflgjnihsptr	lffnpttffkggqlnp
gurlhfmgknihnptr	nmmfiignjhskjjph
qhnqkqrmklskmtjq	jkujjltqgjkmjkso
qhnqrqsmjlskhtjq	psrniqfkolfjmmjn
jfmkqonfogltghsk	ohnonooqnlhjngls
jfmkhoofngltjhsk	hgsoqmmtgkqolsni
hljtiktlkukmtfuf	jrfupimmojlmjqrj
hljtpkuljukmqfuf	lffupgipknlnhrhi
tmjhgugjisrguogu	qjqpgfkmtsnrfknf
tmjhnufjhsrgpogu	khjjuiufliqjghrl
kffiooqifstpfrlf	ogqjqihqgrrkufit
kffifopigstpkrlf	tkignoofjtmjfish
jlijhsffthfnhrtq	pjhqppoqunhtikqp
jlijqsgfuhfnmrtq	qhnosshgrumlqtls
klrgkoloihqlumsm	tpktoinlguqmnrgq
klrgromohhqlpmsm	rustsqpffuksnmij
urpirmnhkggntglh	fglsolmlhgsjlgof
urpikmohjggnqglh	uqfkmgrgrnjoiqso
jupluhotlmnskmhh	fglrmulfrmtgrfjp
jupllhntmmnsfmhh	usgspugfuhkgppif
ukfopqfqlssmungs	kpgjnqltlhooijtn
ukfoiqgqmssmpngs	jprhifpinjmkkjon
sqnqjffjikuuoqjn	khpttfnoltutkogh
sqnqsfgjhkuurqjn	ihinstklprqlgiqq
jokiooisujfplmui	uprsnjriggfirifk
jokifohstjfpimui	qluunrkojfsllqml
nrplghgshgooghpg	tupmrfrnkfrnoqsg
nrplnhfsigoojhpg	kknksmorqiqkmkrh
nmolkolgojusrjsk	sjhomfqlupnkujnp
nmolromgnjusojsk	pgumnhuhkjpjmukl
ssqsrluiskfulmuh	lfkiijhnjngsorsi
ssqskltirkfuimuh	phpmomnmgqqhkpto
rtpgsolhhrplrsjt	pskgnqishpqfnmnn
rtpgjomhirplosjt	komjlhhfsgguqutn
mliiqkjphltnjooo	iohmsimqrqtkrpss
mliihkkpiltngooo	mqggkpmmjqjnnuui
jftipsirgqhjhmft	qhfffsqqrrlfjjru
jftiishrfqhjmmft	ingnnofkihrfqojj
ppghjimirrgpplho	tqkoqsgiuqiphsin
ppghsilisrgpulho	sntfrjrpohthpmnq
nlkqhotmhonfnpiq	mtsthmkqmpokhrok
nlkqqoumionfspiq	pkqfgmrguklgrrjr
lgmftjojtfuhomml	kkmmkhoqpuorrfkg
lgmfmjnjufuhrmml	mksilrmihgqjqfjq
rlrhpsjqhlkrhqoo	nfoiqtimohpumsju
rlrhiskqilkrmqoo	lhjnkgmhlmrnmgqo
foqmpqtolkhpifhr	pfstfhsjqkrkjipk
foqmiquomkhplfhr	rtutggtlrhomligm
lkhllmrpupktkklg	kqnsfoojpstrnnih
lkhlumsptpktfklg	mkmrthnggltmfrjl
muprjqjlrqlrosiu	gfqismfhtsoolqmn
muprsqklsqlrrsiu	qojfljkkiikjjjui
kfonkiftmlhqfnnu	phjtmgrhkrqsljqn
kfonrigtllhqknnu	okimffnuohnfjkqf
oirtomkkkhjnhifi	nfrrtfjguorououo
oirtfmjkjhjnmifi	oqrsnlkrfrgkifgn
fsjjggrnploprqok	gkipnukkmoqhufno
fsjjngsnqlopoqok	irkgofrmtnrultqj
rntqtfijhtlrqhli	mfhspprlnimishfk
rntqmfhjitlrthli	iprooofkkhqlkgin
nfntggttiltuiqpg	mklqsmgssuqotskl
nfntnguthltulqpg	iqugfkmuhmrsopgl
koikhtmohijkigkg	froiipmnfmissjtk
koikqtloiijklgkg	jtrqpkguprsqjihr
nkplhkufkgihoioq	ntlngtnrhunrkurl
nkplqktfjgihrioq	ohjoiuoiohgohiir
qpmnomjrhsukigfu	puutjrmgfgfkirgl
qpmnfmkrisuklgfu	hpuutrqtmjhisush
gtftsfpjuftmlhnt	slkqrjikkqnhotgr
gtftjfqjtftmihnt	ulnsufrhjsogiqjh
umrjnrskqouirkuj	qsjfmnlqjhjqfhtq
umrjgrrkpouiokuj	lltpgtsqrkktjkor
ptfgomgjfmgfuqgk	tqrgfkjmpngohnhh
ptfgfmfjgmgfpqgk	pojmlhifishmliio
rlmqrrsrtnjoumkh	psrgigqignrsjojl
rlmqkrrrunjopmkh	mnmqnrsuouppgmgo
ukquqgtnpkinktjg	qmsgfgguulrpisiu
ukquhgunqkinftjg	lllmhrltffookmgq
tfrqqjfgnlnrjkgr	ikilujrphghpmomq
tfrqhjggolnrgkgr	tjkllfsmlloofpth
fkrsptkhnkljkilj	pgpijqlogglrmhfi
fkrsitjhokljfilj	orpfhupoqijjjlqh
insnrunfqjfjmuhq	hhfptpmnsffrjofu
insnkuofpjfjhuhq	fkskjnupqmkptimj
oikofikgfnopthgk	uqnfulnnkkqgsfql
oikooijggnopqhgk	ujhlllmkhounqnom
lrmkppmrirnniqpk	mhotnutkjhotgosr
lrmkiplrhrnnlqpk	gppjjihmspsflujg
pgqtuftmrugguhhf	ojpnnksrtpohqtgs
pgqtlfumsuggphhf	ilhhuhnoookupnlh
kqnmmgngpnfliqjm	ulnuuohtspgosumn
kqnmtgogqnfllqjm	qtjglptomsuggmlh
klpqjlrgkrskulsh	glhriorgjospfppq
klpqslsgjrskplsh	ljntutqitomhokqt
fguntfifqshjjtqt	nithqkrrfksqugtp
fgunmfhfpshjgtqt	rqfjhnurjqluopnn
puqtlqnfomhqfoli	mortlrihmgofnlrr
puqtuqofnmhqkoli	srumsisfqjguukos
lrmuhtkpthsskkjr	sonhhqnggminsqrs
lrmuqtjpuhssfkjr	jusuujffkjitsluh
nkprokjjgpkrmftj	uoqtfukpgorslrlm
nkprfkkjfpkrhftj	ltpltrqmimijfhop
uunfqqjgspttrtmu	rnmotkkmjmumrqpq
uunfhqkgrpttotmu	fuqrglqntrmljuql
npljfmhtptposhhi	pogifouqsjhhqgrq
npljomitqtponhhi	tpgmhprmjtkpqior
srmpiiiojossgntu	fjfsoompmklhpjnm
srmppihokossjntu	kluqgsmiqlinkknn
ouoguhqonnhsjonj	upgtniqtojusjhpr
ouoglhpoonhsgonj	sjjigntposfhnpgu
jiropoqpoougmmgp	qnmlkjrgpjhouipt
jiroioppnoughmgp	qhtskiprrpjpjokm
lunsponshflmrjli	oitfrooghtmnmihj
lunsioosiflmojli	ulhtjuhshkpojrso
ptpslqhufqnipllf	mionllmsgrjkhuus
ptpsuqiugqniullf	uurhutsrprtlpkpq
fjnomthhnnqiunru	ohhroioojhgorupu
fjnottihonqipnru	soughjijrqqhlnos
fujqnukrpqulphin	iiflrjolrsrjgflt
fujqgujrqquluhin	mmtspfnfiukpqjim
tpggtujpjtupsfgq	hitjknqptqsqgpjm
tpggmukpktupnfgq	rjfuhtigorihoojq
rpuksqmtgqotomnk	mhjsrghpphnqfguj
rpukjqltfqotrmnk	mqtpuulplfnospol
nrohilqujilfmiui	ijmpiouhoikuofgn
nrohplpukilfhiui	tpjtlogfuqsruqtt
qhilpglqfqkqrfpu	trrgjfmsriuhmgtr
qhiligmqgqkqofpu	pnhqgfqjgkofoifi
oqqlmlufrljslius	lpnjopqoipofglrl
oqqltltfsljsiius	uuthouqqrgfftokp
oqpktuiutolsnmqt	pguhoopunkuqhhuh
oqpkmuhuuolssmqt	hmkgrknrujsftigp
surlqksfnsnilior	sjsiptgfmnurjqhf
surlhkrfosniiior	ijfulmthpnkjrrno
lsomghpsjktknosn	krljqlrnulkfkgpu
lsomnhqskktksosn	lpfthuhshrtkikhl
rmhtmrrrlqimstnk	gnoqhunusngfkthq
rmhttrsrmqimntnk	hiqmklgumfmrrimt
mlrqhumkmrhntkrq	kggtqkumggphjfmn
mlrqqulklrhnqkrq	hgurusomqqfjfljk
kjropqsoktnipkrq	okkmqgoshtgjfrhq
kjroiqrojtniukrq	isrrjujshhgopsgg
ptsrhlmqtgglrupo	jmnpqkmuqjgjsmfh
ptsrqllquggloupo	gjklijunurqukptr
osujmqspritthsih	lqkhktfjgltjiqpj
osujtqrpsittmsih	qujrtsnfpufquqpn
jsgijpngkniqnlif	qlsolgqppnfsmkii
jsgispogjniqslif	gsmjqgqqoutjrghr
tqnjlqhrquutkris	rkjkhnfhijgffttr
tqnjuqirpuutfris	ghmqrorqgpqulqrs
mtfutljukufkufnq	smjhpmukuontflrp
mtfumlkujufkpfnq	utqlpghnjgipjftr
rknurnnppfmrupjq	puklkpprsmlrkfgp
rknuknopqfmrppjq	qnmgtiplgillnihl
jsrkrtrkmirppguq	giophnurpursmlsr
jsrkktsklirpuguq	flhpqirmsflmifrq
kgfmkooltppsgruq	jojmsknhmsgftokm
kgfmronluppsjruq	mulsurunofnnlnrh
kjmtpsfuslofmijl	ouhkkukrrfpshgkl
kjmtisgurlofhijl	ptmoonpujkoujhrn
uqqitokitfpqsfrq	umrsilkjjikilrjo
uqqimojiufpqnfrq	ksqrgkninhiqrkgk
ukorqnggjhuihrfl	rpofjpgmkmpjfioo
ukorhnfgkhuimrfl	hripfrtholmklmok
itiunsfnhqfqhjrr	irqggoltgusifjhi
itiugsgniqfqmjrr	lsmupjiqngmrppmt
frlplkumkslnpqpt	pgkssjgflmjoosqo
frlpuktmjslnuqpt	sptrgkspujskhrpt
ukqtmqjfpoikjptf	qjtmngfgqrqlrusg
ukqttqkfqoikgptf	jgkgriuhqihnoksh
rtjqrqqmjogngmms	tshfsnfrninqniul
rtjqkqpmkognjmms	rhjsjjkifqhkupho
jjhsrhonnfroutum	qkngosulmskhqphs
jjhskhnnofroptum	nknogkirnhllnfsj
rjjkqoofjfmpjjlj	pihfoopouhmnklrp
rjjkhonfkfmpgjlj	lfukpikuqriqhlfi
rqflffmuhslotuuq	oqsluhjksffptusr
rqflofluisloquuq	pnmkhujkuhsphsqg
ngupilktjginfopq	pqlumgosisloqkoj
nguppljtkginkopq	hqpuufnogkoogopu
ruuqskqiikkmoqtf	puhfoffknionriro
ruuqjkpihkkmrqtf	hqislthqktokoksq
kigjlmqkromfgpui	mrsoqstnhmruftog
kigjumpksomfjpui	piqfqpstjmlpqlug
nrfgfmlksglfftrj	sqhfriokqhpukgqt
nrfgommkrglfktrj	hqutolilihtqtmhn
lstrhohnltpqqfsi	urgnkogmnkrppssp
lstrqoinmtpqtfsi	nfqfnsroghnmnioq
mgpsigiflnjtrtkn	nhiqfkpntkhsuuoo
mgpspghfmnjtotkn	thpifsoiugmkgukl
tothjjnoufuhquok	ohogqsofnumuphqg
tothsjootfuhtuok	sigifitsmmsnqlqh
pfqrmjhsiumlsfqf	gtnipfflkosjorfu
pfqrtjishumlnfqf	qroktjnqissfhfor
htlsrujggnrkhhnq	nfmmrgimlllomlum
htlskukgfnrkmhnq	uumrtpmlhisigmlm
qrqpqjqfsoqrgirg	pmtkrhsfihihmign
qrqphjpfroqrjirg	gojfffmrihkmsorf
itjklttuuppfknis	pfrtkionuukrklkh
itjkutuutppffnis	tltimplnkjominfh
itqlljurlhlpggui	utqrunkpnfpmqfls
itqlujtrmhlpjgui	qlgqhqisfnsufmfj
gtnounrjnirrkqqt	jrqftmugormhuism
gtnolnsjoirrfqqt	tqlslofqfsktnjqp
rgsghmtfmiulqits	ujqfshpljknnppki
rgsgqmufliultits	sqiqrluunlmfhgql
lppqltqugpjumrmp	mohnsgrgpumkqkiq
lppqutpufpjuhrmp	fntsojgrtgurrqpp
otonkqphpiruqori	pnkkqgjmiofkhmkp
otonrqqhqirutori	itsloktorgjltrjp
mtkprjjqitrstqql	lfgponhsqfnflqin
mtkpkjkqhtrsqqql	skmuspmkjlgjfshh
lfkqftrjiuuisriq	msijpnknjlrgprgk
lfkqotsjhuuinriq	lrtllnmjnqmqnfjm
qtuffqsqgfkiotqg	tflotqnplhrimlru
qtufoqrqffkirtqg	pppjoqiprrtlrgll
olflllqjmookljii	gjnngnknomruojhg
olflulpjlookijii	utjnskfjphilhmjp
ougrfrttoithqpuf	qtstmjkffkjifsmn
ougrorutnithtpuf	rrksqhotrqosuljs
gqtppqgmgmpplhqo	qhpushpjtnpmgjsf
gqtpiqfmfmppihqo	onrnomppghntirkj
kjitgqtuklltiojp	unllfhsgkjukjhol
kjitnquujlltlojp	tqnninkupkfgpnhk
pjoptltktljgjrjs	mqnsiiokfqgmiqpl
pjopmlukuljggrjs	ftpgunoimglpslgt
tqsopqsihhllqltq	jilsfqtigpppqsls
tqsoiqriihlltltq	qsffqouktpptpmrh
ftfitutorohfkkhf	sjquuiikislfgjhr
ftfimuuosohffkhf	tngiouppqknihluo
iufkqrnihutkjokp	sktfrnrthmpjfhss
iufkhroiiutkgokp	jtpksunrlunslutf
iqoklniihfgiglji	gnjksugfnirllqrl
iqokunhiifgijlji	kjrhnmljtgjgfolu
ngmifmijtlsgfmil	noqsfmmqkgtpljqs
ngmiomhjulsgkmil	pshgpsspgtsukjko
mkmukqpgrfolqkgu	ropnikrurjshjtum
mkmurqqgsfoltkgu	nogjkttjltqtqsgi
rrqjhotutsfrmutp	uuojgtimmlrkttls
rrqjqouuusfrhutp	sgsitlfqqihrrhuu
nkpmhkqlgikfjmnt	ljlkfnjiqfmofgjg
nkpmqkplfikfgmnt	osrtjspmlnhgomki
iqjjlirfjnkpjghq	usquohuhqurogpkh
iqjjuisfknkpgghq	uqftfknfpufirfin
pfohnltujlqhmsog	qrulnfhfgqhutjlr
pfohgluuklqhhsog	qnuhtfffiqhujjhn
poipfljsofspurmq	toqsfosklfnqfnug
poipolksnfspprmq	qolthooqlhkjnkpi
ksqqnkftrlrfkiqf	hourftiplmnnrfmn
ksqqgkgtslrffiqf	jusoisrshffripii
uurgioroqgkfifrr	oqtnsisfirlsghhu
uurgposopgkflfrr	irfunujjmorthuii
njsorpkslsgripoj	oiqipsujihlofimg
njsokpjsmsgrlpoj	lftiitkfohlijfgi
pgslninmgorgqqjm	rsqlfjsjnmjurlik
pgslgiomforgtqjm	ttskjqfulgntkssu
kqmogqqnsnsnsuif	oprlkqqtuqfirpfp
kqmonqpnrnsnnuif	ujklqrjougqkrfhl
lhphknkfqjjhioih	gnhflofsiugmigjf
lhphrnjfpjjhloih	tplfpguusolpgltl
qsfmgqhihohirris	ugfttupgnphjlrks
qsfmnqiiiohioris	klkoqtlpsnqmmois
skhfpkiqjpkutssj	riqnjqllogpkiijp
skhfikhqkpkuqssj	roisjrhgforrqgpk
skojsnfntinfjhnr	tgtthsonlufhjult
skojjngnuinfghnr	urknuflnshgjpiio
olghqjktktnpnpnn	jjjqjlnnfnfpifjk
olghhjjtjtnpspnn	mofnqsfjrflsfhlj
iunuuftnuplqqkjq	oijhmqgkjhnthpgh
iunulfuntplqtkjq	slhuuigroijlgisj
pqmpjprgjnoojoqh	hmkkuutrtltogtrh
pqmpspsgknoogoqh	sijfkqnqnlliuijt
iuqhfkmltghruhqp	nolorklnomptumkq
iuqhokllughrphqp	unjiqfrpfgtkpmjs
hrklnfiklmrkoiog	ghfqtuqstrqotpif
hrklgfhkmmrkriog	fuipjohsmpgtslfn
ilnqukmnhqhunpst	lmfghkqjokqrnusi
ilnqlklniqhuspst	uujgumslujkmplgi
ijsthiullupggtqr	jisjnoghphnlohrm
ijstqitlmupgjtqr	ktqftmhumogmiglf
itpipfhfssqptgfi	mnluiomolgrjkfnt
itpiififrsqpqgfi	nukihfqtpmuhsfij
joiqqljfrprfuslq	nukihfqtpmuhsfij
joiqhlkfsprfpslq	lghijmqnrlqkjigu
jtukhinsothjrtgi	uuoqhsptjnftpnim
jtukqiosnthjotgi	fqmoqtqjojgnstnp
tntofhtrpktmolhi	fohpnopjjpiqshjr
tntoohurqktmrlhi	nqrtrifthmrfmtik
kipsnsngkhohnrmr	uoqisfhhiiolsitf
kipsgsogjhohsrmr	gprqspoitsrqfgfi
rugnlnnnjnqsrmph	osmikumkfnigkpnt
rugnunonknqsomph	tqlfqiiknonukkmk
tiinputtuumlogug	ufopomomsrplpjsk
tiiniuuttumlrgug	pkhkrkqgtfojonsu
uhnfuujmokrosilr	fimsnlspntgjsktk
uhnflukmnkronilr	usuugospursnsjgt
tpsilphffkfohugq	fqquhjfmksofkril
tpsiupifgkfomugq	ijfohkgfpoofmqmg
rojmqpigtorhjluo	fhtmhfiprmtigrrp
rojmhphguorhgluo	fffsrljjtmjnrtrp
unkjqsnlrnntuukm	lglprtptqommghnr
unkjhsolsnntpukm	qflkjspfuoqofqos
illsjjkjgqristot	tqfptltgqtponimu
illssjjjfqrintot	qmgurnoskpjtnkgt
tjnhmmmfhfukmgin	mlnufutpnkjsjhkj
tjnhtmlfifukhgin	tgtiginukntqnklh
kofuqjlfqgrjrmon	umhnlillhsmpuqsk
kofuhjmfpgrjomon	minnghorquiuqiop
msmkpfiomfsifqis	umupuhssqlrgkmjj
msmkifholfsikqis	qrunkhmsqiojjpfh
hkflgqqqutlnhgon	mioshgttkjigqmsh
hkflnqpqttlnmgon	jfkogtgokrimkiih
ssrlmojltqfjgmtg	lhghqfhorokjtmop
ssrltokluqfjjmtg	kkrjrputmjhknfhi
tqqppnomnopfrnss	iokhutrqrifjtsto
tqqpinnmoopfonss	pfpflkhnnktmfkji
ihjkmflfomtrrkgt	srorngmsjmifgopt
ihjktfmfnmtrokgt	hpoqjuskmourqnmf
qqghirjpufjpflfi	ttsolugpjtlsmikm
qqghprkptfjpklfi	tjhfhpqgsugtnrmo
gshkuruglfhktfok	uqpkfsokntmthslr
gshklrtgmfhkqfok	ipgnorfhqtfnllsm
klorilghiltqilhn	rjorhhgsokununmf
klorplfhhltqllhn	jpiktlorgqonpppn
qopkgugmironqolf	higihusnrmlhifnn
qopknufmhrontolf	pnitmkuukkruflgf
onmlmtntknmmttqq	lngurohnfkthnfkf
onmlttotjnmmqtqq	gorpnhugjnhqjghi
slgmslnrrujtijpk	tgjolttmpqplnspk
slgmjlorsujtljpk	ptjpjhprorsmfipt
qnrigsikmgqgtpll	ulsloipuotmfmkqs
qnrinshklgqgqpll	ugfonntouohpnihp
mnrtllpiljokgusr	ultjpklkugmgjlqr
mnrtulqimjokjusr	kkljhssgtjjqnlit
nkhsjjtjslfisimn	fotkgunqmnrrrffs
nkhssjujrlfinimn	mqqmrmknrjqjonqk
hthuuhnlhjmrgntt	usmmqtssunqiihhk
hthulholijmrjntt	gopmrrmqukhrmoin
sjpfkrgnhfgurisu	snqpisiosktrkqsj
sjpfrrfnifguoisu	kssfngfthguujkku
nghsmmtgigmtsiun	pfioqhsrrmfqjknr
nghstmughgmtniun	mnrgjgptmhqttlml
gsjgukpmkonmjoqu	ngiiikmfuplfhrpk
gsjglkqmjonmgoqu	oprrqkfqnmlumlmm
ojsntkhqmkilnjms	khqpufljsgrplsjk
ojsnmkiqlkilsjms	fjftuptsuhnsignj
ispfjsilmlmjqoof	mhtijkjqmrqmsrno
ispfsshlllmjtoof	rtfukofnkssjklfp
kiulpintlfnpitgq	jjlsisuftljsggso
kiuliiotmfnpltgq	fimhgugihijtlnri
ojjitjjtpnphtkrg	mrhsftiqsljmtotk
ojjimjktqnphqkrg	uotlrnfouprrproq
mfsnrfrpfqsrpmhl	suprprjummnpqfiu
mfsnkfspgqsrumhl	tjohgujjhgipqlur
njshrqrtsmuqhkii	osthljgnnspuojss
njshkqstrmuqmkii	irjsfqorphuguomq
ijlrrnhplplgouto	njiggifirjlkmpoq
ijlrknipmplgruto	slulmnijnmgojlou
nffjgspikqjffmki	nppofrqfrugusfgq
nffjnsqijqjfkmki	rlimilnirslpkogk
ouiqogkikuuprsju	fjsromoorfrsplun
ouiqfgjijuuposju	ppkifoggtjqjtfhn
ktnhonlktsmkstjp	lqtfiihoorlpnsoo
ktnhfnmkusmkntjp	mrougpltirngknkk
fknqnusnilnooohk	nmjpkrmrmtjjonhn
fknqgurnhlnorohk	qfnjnglliojfuiop
kpmrqqugqmgpfoll	nugshjkhttmulgsp
kpmrhqtgpmgpkoll	hrhfmpnsrrqioupk
qhksqqmsrspjurhl	omfrhpjnqhrqntsk
qhkshqlssspjprhl	psqmmlthrjmmgshj
qlkifnqpllftohgu	mrufnthujngqfiqs
qlkionppmlftrhgu	fkgrpinpngtnsits
khfognqqlrujhnmj	fmskpkkgrfuoluuh
khfonnpqmrujmnmj	guuourkhsilqlmqs
inljtpfgnpugqupm	tmjrostnsohnlims
inljmpggopugtupm	umnlfsjlhgmohift
junrpqtlmimqlsqf	rigqjtopiojqttgq
junriqullimqisqf	mgpjjqglsjmsngrq
qtlrrqgrijqsgoou	opphtntptintghnj
qtlrkqfrhjqsjoou	ftsgspgltpfmlmfq
tlgfgmmlntgpufnq	murougkhimpkonff
tlgfnmllotgppfnq	fkpiiptqplqrgtns
uimmsnhqhmkojnru	gtgffmotmikrhgii
uimmjniqimkognru	omliipijqnsmrnfu
irjfjlpiufrsokfl	sshhjiorortolukh
irjfslqitfrsrkfl	tgojqqjnqsnopfno
osfmijuijmmhkhfl	ifjjmrlrhnlktgif
osfmpjtikmmhfhfl	ffnqsqnpmipnfgrg
hpfohqojlugfjgth	qukpnjfnpuijjspu
hpfoqqnjmugfggth	osnsmuilrujhnnsp
linonoghjjrnifpf	qsplsiqgmphqfmmt
linogofhkjrnlfpf	lmfksnulkmsssgui
miorfkklihoskruk	lgnnpgfnijhmirln
miorokjlhhosfruk	nusihqfqriofjnjp
gjgpihuhffuptjhm	qumhmmfqijfuskfp
gjgpphthgfupqjhm	moqqtflopttftkhg
frfiqmmklmjsrtjp	tgpslsroqmiuqgrg
frfihmlkmmjsotjp	ohqutskpfrujtupm
phnlqqmtifppuprt	huiknjogkroippqt
phnlhqlthfpppprt	htnfiuosphmjgniu
hltnpngffhmmppqg	kqklsgkinnthljsj
hltninffghmmupqg	fifhuhionohslihr
kqglqqrjunrhmhjp	suunruippkonlilo
kqglhqsjtnrhhhjp	psfjrgfknmphnuff
htumjfprrfqfqigo	unorjgmgolrqiifs
htumsfqrsfqftigo	tfpinrposgimjmml
lfiiirljfrpftogf	hfprkhoqhuomillg
lfiiprmjgrpfqogf	tfluomnkfosmnimj
gurptmnkpqtiitpi	kjmpftthprflotjf
gurpmmokqqtiltpi	kgsqmiqmhqknsnki
jsmlqlkknogttkiu	jqrtfuluqnmhkgtj
jsmlhljkoogtqkiu	srpglrrtmjipsmhr
ifpmlsofptqnmgpk	hlmohfqpukitqhkg
ifpmusnfqtqnhgpk	tutqrglsnsmfhpjq
hsmqqhmijkhpqgqs	ltohlhhjiupsljtt
hsmqhhlikkhptgqs	rklinlrpggufourl
upjugulmflhuihqk	fpklfhfjmmjujqpq
upjunummglhulhqk	lpopihkfhhuiusik
golkgilfqmlossho	rkpnrtjlhhlmjkms
golknimfpmlonsho	fgnophghimootfgu
mrtisuijsgkoimqk	tfufijfqspjqjnkn
mrtijuhjrgkolmqk	pfmtofmmkunijpfi
qqlhpgugjhpqqrns	qqqsirpknrshjrtq
qqlhigtgkhpqtrns	mqjiklqnukgufshg
pjjjtkjqiujhqgnf	tphqknogmrfsjlqj
pjjjmkkqhujhtgnf	hqfjkonfskguthqf
unmrgiggpgqjpush	mqhirkplkgoitohq
unmrnifgqgqjuush	kgqkgsqtroioquhk
hsunrmosfrgfrook	rkpjliksjpmhlupu
hsunkmnsgrgfoook	krpgmgpuosutiuuh
hjnfhnjjrtskpgrf	uofjjqjhukifpfuj
hjnfqnkjstskugrf	jisllhrjogniqrgr
luptkimqnipslslp	npntpgjjpqquiofg
luptrilqoipsislp	lofjuomffmtukujq
mhtrongkuoqghlll	iupmppmqmjpfnttj
mhtrfnfktoqgmlll	gkgqhlnngtmlouff
jjnohokjfmjlgpkh	iutfluuoothoquoj
jjnoqojjgmjljpkh	oftqpintugtijpjt
nsounuiqptgfunos	omifhsrgfoghgjou
nsouguhqqtgfpnos	prgojtrsuhtsptsi
kmhrihqqulnoksrk	ookmnfhsfmmljfsi
kmhrphpqtlnofsrk	ofnormgukfsnktrh
ooknmftjrtpgrijj	rtlqhlhmslhgqitm
ookntfujstpgoijj	jqgitiujllqsjpqg
onkuhkllpkmmjufl	guojknpppffmgskl
onkuqkmlqkmmgufl	suqhrlgshtuquhqn
uoqqhgkugujgfqnm	ohrhgnighsmlshtp
uoqqqgjufujgkqnm	rsnmiusmjimtfkou
ihnguonjnuihhpom	jrjfupplrstqujpq
ihngloojouihmpom	mhklgflkuonmgotn
upjhpthikghhrsgg	lrhohftnhipigouu
upjhitiijghhosgg	kqjpiknrplqiiunp
kgfigmkhusljqpnt	hhiuplffrgpqqmgh
kgfinmjhtsljtpnt	qoorpinuohsqhtsm
jhugotprrtuugohh	tlpitsntnjfgjtul
jhugftqrstuujohh	tlphomnortjloplk
pkjgossgmlqinkuh	gtfpiirqqrtooulq
pkjgfsrgllqiskuh	ltftrlpsqtqumumq
mojmlqmtjfoigkop	npfnutnnnnfmslfu
mojmuqltkfoijkop	olqrptplrmofqnjs
tmnsqqshkrmuuppg	utlqpipqsopnrmns
tmnshqrhjrmupppg	ugqmoinlfnnillll
slkjfnmpufotfulj	hhnqomltruptjsrm
slkjonlptfotkulj	nhqrffuripqikiug
rpjmlpnfslfghimg	njskrpnjpohingss
rpjmupofrlfgmimg	gntuohsjtikrpuni
sstqkkijmlpokggk	noouskkhthmjtkpi
sstqrkhjllpofggk	rqtfpkphmuorkkjg
rjntpmnpqgkroomq	jmhqrrtljfuprnml
rjntimoppgkrromq	sfpkpqojnpogtmnl
hksoigqppujumtuq	stqisrsjhmmhmjgm
hksopgppqujuhtuq	uutonmgpssohjmsn
mkskrulhlktktulp	hrhfnpkhtljnphsi
mkskkumhmktkqulp	mqujpmhjlsktftkl
fukjgtmsfgirjqfh	uhprnjuqotmsglpr
fukjntlsggirgqfh	nlkffjffmuthshkj
miugukqkkjmflfun	njsmjlfokunuihqh
miuglkpkjjmfifun	rkikjuofqkllfmoq
lgfjormlfqsgjfmo	luqjtkltiplhhqjm
lgfjfrllgqsggfmo	frjgouijqurouskr
omqoollqmfspgqqr	jrqtnltkpfujhfrt
omqoflmqlfspjqqr	ukmlrutlijllqsnj
qrflstngnhgflpkl	ougpsqkqktfolpkg
qrfljtogohgfipkl	krrtpplhurllqjks
hhupnorinmlglkgr	ijhsrlmkhlgnofqt
hhupgosiomlgikgr	opmfnhjqmngnprfj
jnnnmgthgnqfmnkf	nlqiqqnllikslgfn
jnnntguhfnqfhnkf	npouptkmllfqqlir
rjmfqftsrqnikgnu	nfjolsogqlufpnut
rjmfhfussqnifgnu	ousgnnhoiiukfrqn
pumihgsirrtfkpot	rpkfkpjqhmggjpsj
pumiqgrisrtffpot	igkssnmghupssioi
fmofmnjmimnsfsgq	jujtturrhqtghull
fmoftnkmhmnsksgq	nmpjooimuultmslj
pslgquqmqkmqoqof	snkmtqhlfuqnnkqi
pslghupmpkmqrqof	qonfrmkskirmuqkf
sjuqnjpsgqpmplmf	hpfiqqkukipmskrh
sjuqgjqsfqpmulmf	fgrsuunfjkuqmlti
jglrlrjquqpgsmsp	pfnnglqfpmsqstlu
jglrurkqtqpgnmsp	ssmtjktnitkknomu
tiqiggqjigoffmim	jrthtfitksgojqgf
tiqingpjhgofkmim	npksgnqrsttqfqnu
innfqinromptppgn	hmstjggppiprfhin
innfhiornmptupgn	kojhhfurjpjjopuh
mqtsinhhnginrjnn	tuquhpojsuttllgm
mqtspnihoginojnn	lnukoshkutttojis
rfjjsolonrshofkp	mphpiomquqhupokn
rfjjjomoorshrfkp	rotpriukonulplrm
nuoojhhuimjihmto	pnkpimiumtmlqsms
nuooshiuhmjimmto	onmkotpitnjsokpr
prqonpktunktqmtg	mkrfglpptkhgkisq
prqogpjttnkttmtg	kphihhifjifsssmg
rotmgfstmgslsgfs	igrhnhkiktnuhfof
rotmnfrtlgslngfs	lrknqrihkjoukuqm
imnrrjjmtgouqlos	gogskjsolfsuigun
imnrkjkmugoutlos	quiomfliumomumpi
suskjsffiumgingh	grfskonssnkpotsl
suskssgfhumglngh	htgsrfmlinlhofpo
qfjluhfrhtppmglh	huonmstsfkfnssgu
qfjllhgritpphglh	olplgrhmtgpjjumf
tkopqsksgpsrfhmr	rfigupjmjlhsqumr
tkophsjsfpsrkhmr	krkrqolinsofukmt
tuouusimhqlounhq	rjqjfjsimjjsplkl
tuoulshmiqlopnhq	tiokhlrslgjlmlli
urlgrihnuihpihjm	somrotjnrkfjkuuk
urlgkiintihplhjm	nrgpqitjmpksfmtp
hugllftgrjosomfh	ugmjuuopigoiujgr
huglufugsjosrmfh	quoojmlfmmlhjoko
mpqpmpgqkinfkugn	oisrhjpmijjufoqo
mpqptpfqjinffugn	okphmuimhipkqqnj
rnrougsmimpgqjjm	rrlsphosgtssmupt
rnrolgrmhmpgtjjm	ojnomhfskppkftuo
flnflknusjlkjsgu	qoisknkmnuqmopfg
flnfukourjlkgsgu	hipntjpimnpmsssn
orhmpktroslqtiui	fgsinqjupmrgolgi
orhmikurnslqqiui	ipjhuussktqopjlf
jpifkritmhjkppfo	npjqulfjrpqniqft
jpifrrhtlhjkupfo	hihnrjtghkffokrs
hjkhgljrkrqfgkho	gnqsrkslpmtoskrl
hjkhnlkrjrqfjkho	pioqnjshkoqhfsgq
lqslouqfhqstqfgs	gtolomhpmhmgtkuf
lqslfupfiqsttfgs	minfnknlrqkoihqq
tsrklmjliojrpmrp	khgpmhtnigmjffrq
tsrkumklhojrumrp	ttupfqlqmpgmlnmm
hsmistouhtthgpfg	hgpjqfhhpmppuiqm
hsmijtnuitthjpfg	guhqploulkmktstq
pngiosktkolmthgo	lsukojiuptloukks
pngifsjtjolmqhgo	optrhkuuloqussht
lqhmlurltoqmtouq	soloomnuofsjjhnk
lqhmuusluoqmqouq	qimpppkqphktfrpf
jspuflmjqppotghf	jshgmrpmrotroplk
jspuolljpppoqghf	jrmgmnlkqurpphkh
mhpsnmkkgjfslquf	hilpgjmomnjufjqj
mhpsgmjkfjfsiquf	tftiiotlonmpkpfk
kknqmurjuoslmftu	tnmtlpfttsqfhlpr
kknqtusjtoslhftu	honrsfsoulihlhfu
furfqsjohmlmpjup	umjkrugujtsopqnr
furfhskoimlmujup	pgjnnjmhqhmsiflm
jiqgsggolnrgiprf	finipqrhjsskqmqh
jiqgjgfomnrglprf	kfugqjgiqkrkjkjm
rsghrprsglnrhfpn	ktmijmfkrmmopqsq
rsghkpssflnrmfpn	mfntrfqjnksnqrgr
sffqoshqmmflkskf	jopqfhirqjikrntj
sffqfsiqlmflfskf	iksuqphgrtgrpjkn
lfhrninkkuujpsgi	ljtugiflgulqtjor
lfhrgiokjuujusgi	hjmnsqgltsqsjngg
nrtunmgtntsrrhpo	fpurumplkjptlslh
nrtugmftotsrohpo	jhittkjpkrrifiqh
fsoqsoitmrshoumq	rnrpiuphpffgokfl
fsoqjohtlrshrumq	hlirlqjfssntknnu
gkumjlqrhqmjogtn	hmfumqgnugitmjrt
gkumslpriqmjrgtn	ufirfqrgtuppspgg
mmjfqofgnrmlgjrr	ntuhlookqrhhnfgr
mmjfhoggormljjrr	fhttgirnhkojmomf
ninqjkggtkqfkhjm	phkrlmjhtrohrirj
ninqskfgukqffhjm	qfoulptoqmnjrork
tkpuhnsnntmflfmf	kopfjlgiorlnhkmg
tkpuqnrnotmfifmf	fmgpmgulhtloqhkh
hnofrhplpfrippju	llhiifhinrmsuqjf
hnofkhqlqfriupju	ornlgmgqmntghiri
plrltmsnftnshrmh	sfiljmsjjsgtophn
plrlmmrngtnsmrmh	lhilifoiljpqnisr
rfiqluifuiitsqqf	hflrlgtpjjgnughk
rfiquuhftiitnqqf	lritrrrhgmiktkji
mgqlhriimlnltnlq	fihiqjpfjuhitkjm
mgqlqrhillnlqnlq	rpoihqopnknsnlfo
ipnjpiqtjlnfnjts	trfjhtmpnklignkl
ipnjiiptklnfsjts	iqrsmhtlpukqutik
fllkitrnumkhtmkf	uofrjurplqnhgskk
fllkptsntmkhqmkf	lmghkluumhgljkim
uiljglnlimqujtjh	npppnjphlnrfgqgq
uiljnlolhmqugtjh	hjttkohjnrttsngu
oqtlqimitgoitgkh	quqsktrhpslqinuf
oqtlhiliugoiqgkh	lpghgfhlrgntrnpo
ljpfrtsklrnihkrj	kutllkqhloijgijl
ljpfktrkmrnimkrj	ffrglqnjqprprqtk
khrputjuknftnhfo	ujuplrqffsnrnlst
khrpltkujnftshfo	ttjsnjihtsfthjno
hkjmluhfiluphtnh	prkrkthiptrijuum
hkjmuuifhlupmtnh	ittiohprfqliipil
lrqrhtfknkssptof	grjntolnjghqjpfp
lrqrqtgkokssutof	uutmlookgjkjrfmj
uphjomfhrnhrtupo	llqhqfmkmgqrokul
uphjfmghsnhrqupo	mjgpgshuqilkflgj
kuisjtohkhotkgth	lisuqifqpqpqotro
kuisstnhjhotfgth	sfhqoirfohhihkmf
mghqtmohnggsntfk	unrnpnjfqitmuhgh
mghqmmnhoggsstfk	hllmigurgmhpmlos
gnjlghhhrrlomohf	prntiqrqmtptqrmr
gnjlnhihsrlohohf	fsrhnrphrmjlhkkr
utokskltspglljqf	gspjgponpfjjiftf
utokjkmtrpglijqf	mrtrmsmhosrgluih
mjouliqrkmfmkorm	fulpofohppugogop
mjouuiprjmfmform	pknsuhmojiiioggi
fjshjumqorojgfhr	joshmttptksjoulp
fjshsulqnrojjfhr	iquonrntfqkikhmp
uhppgqtkmoponsuh	jsqunmlopmuqtmtr
uhppnquklopossuh	hqiimqjitjqjqlgf
opghfiruohgmlquf	jmlipnpjuiofifsm
opghoisunhgmiquf	sikotusuihupkonf
ljookilhflrngpni	ufjhoutrinfgtsmu
ljoorimhglrnjpni	oogknhgsrupiopmn
pmlokmgfjnmgpsqj	prlnhlqqqjmkmgqp
pmlormffknmgusqj	mpkjjrijrfhitpus
jsrkskngmsfpijun	ugntqjkfftjknomr
jsrkjkoglsfpljun	kgkinlnqniuspggo
uihtlhtlllihltrp	ioiiompmjuflkhgh
uihtuhulmlihitrp	qnuqqhnhpkrmrkhi
msksiofroltrgttj	gihhofjtrjpjmujp
mskspogrnltrjttj	ohnhugninhpujnjq
gquuoqjsiorikttf	mlnmftqkqllrtqls
gquufqkshorifttf	fmsritqmilrjogor
nrhjuogqpqintiin	lhorknhpiotnjmjf
nrhjlofqqqinqiin	injuuofiffumgthm
lutihnokjlijmnok	jpmhkjkjtqqhmsoq
lutiqnnkklijhnok	sgoqkfltinuuujpt
iurlrnltqustqqmj	jgourriitshkmmgi
iurlknmtpusttqmj	ogmfougkpusqhuog
kjilfsojhrqtptkl	ulkjprfjtqlugphl
kjilosnjirqtutkl	htkqsqtmkmtrllgp
uhfujofhrmksgjhl	hjoklqgoihfflurs
uhfusoghsmksjjhl	grlorltshgpgmogr
krktmtroiurmrruo	hknortsihhlnmmtj
krktttsohurmoruo	ktiljtrskrkummtp
jlgnhijitmimufjt	phhsqghgipttmfgl
jlgnqikiumimpfjt	hummsqqhhrpomjfh
ghklujujpfjuqllg	uitkmulkqkusulsn
ghklljtjqfjutllg	slurtsilsjlnftkq
ioquqfipsrsgkggn	hiqntpkffnnkmnrf
ioquhfhprrsgfggn	jfmutnhfsuptluiq
pjmpfpkrlrolkjoo	rstljkrsrnqqushf
pjmpopjrmrolfjoo	jhurphnmoggqjgip
nqjjtshfinlfiofi	ssjtritrnhritnos
nqjjmsifhnlflofi	sgnqhohotoppkppo
njgngpmrrootmfnt	lslfnshmshmmrqll
njgnnplrsoothfnt	jokrfgnjqisiisjk
sqhkufhtftglqngl	qptqitrifgflqspn
sqhklfitgtgltngl	rmshpmqfshnjkkpi
tstjjmlipushfrip	fhguinktonlguufp
tstjsmmiqushkrip	ugoihruhiofngkup
uhmrrffunmhlpgsj	qmnfqlthjmpspfit
uhmrkfguomhlugsj	tjoigjlusihoppih
qjjgulmhmfpsmkks	orkgqsmffijmprtg
qjjglllhlfpshkks	urqkokigsspfnqrp
qqkhsinkujuiooqk	suhufgkpontfiolu
qqkhjioktjuiroqk	htutfiqluunshout
nkfoljsfgfkfiolp	srrrtgornuspsuog
nkfoujrfffkflolp	qlrrojrkgspoolps
ltgjqmjjrkjnssgu	ohkqtllhtkrhilrn
ltgjhmkjskjnnsgu	nqlhuioimikfinpt
plnlplsnojfntprl	jutomrgsmqknkulu
plnlilrnnjfnqprl	tjlmrnrgngngnlqg
offfuskfktkfslri	qrksgupsghuthjpq
offflsjfjtkfnlri	tjlhrktngrinsuoj
isqmjtjsltmsossk	ttohiisjugmgrhgu
isqmstksmtmsrssk	qpsjsfnrplshifnn
ktsmqfplomktgsqn	ltgtmjoiokorfurt
ktsmhfqlnmktjsqn	qlnpmmpnmqukhsmg
gppfsggkfpfnpjpp	ssnnfumgmsfijfor
gppfjgfkgpfnujpp	gffjmfgfgjqiffrr
tmumluhqrqmkfgog	lhmimgqfgkouqnho
tmumuuiqsqmkkgog	hukhpkookpoinolj
fqpnjmnqlhssgmii	gpmfkopkiktrjmqp
fqpnsmoqmhssjmii	kslhpkkoujmtkiph
gkrilnpssprfnsps	jgjjsihnrgniqkqj
gkriunqsrprfssps	jfffggttqkpgnsun
qmlnkjsssprjrtnk	niuosfglqtgtohlp
qmlnrjrsrprjotnk	shhktglsgqqhqtgk
jkkglqjfiflskpfn	tqogkqhmhfgfiitt
jkkguqkfhflsfpfn	kjuijfjlnfpnosto
jqnlfqhimlrtuitp	ijqifpqurkfhqmpf
jqnloqiillrtpitp	fsknjmultgkugsjh
ntkniuriffuslttq	kofqknjgsohpjfmn
ntknpusigfusittq	iqmhilhppgmfnoor
niprtsqmgjunfpjm	tshkgppjnmgtuhsl
niprmspmfjunkpjm	nlrkqrkjpfoiophm
jtkhpqfmqgpfsmrf	onumnsfmflfjrggq
jtkhiqgmpgpfnmrf	kkunrlijshjouofg
injnlnoorhqukggf	qiqnlkmmngplpklo
injnunnoshqufggf	prghtiokkpptqjug
qfffimnggprtrkjl	rionukhsntjumhlp
qfffpmogfprtokjl	mnoqhsntqoifpkrp
irqphiqljrjouikg	ghtrkttkufhmoqhf
irqpqiplkrjopikg	fqnptgpfimsljpfs
sqnqpjgtsffusglo	hqhljfqsnjofnrho
sqnqijftrffunglo	olffstkgjqpnnkos
utolmligogpplrtn	nuujnppqpqnohfou
utoltlhgngppirtn	utjkfjulpngtkhqs
ktlotuprkhqfooum	nuuilguupkitntlh
ktlomuqrjhqfroum	knuomtusriipfrho
hifgtitktsilunqu	islssfijqphttplh
hifgmiukusilpnqu	guhtihrlkropgkin
oqqmjijfsjoujitr	pnonfrksnkuskism
oqqmsikfrjougitr	itjkokjhnqtnsjuf
jgiqiiouupqsgufp	kgtopffikfirooiu
jgiqpinutpqsjufp	jgunmtrknqpnkrtt
lopfllguslsjquhl	hjjfmqhhfgosqhoi
lopfulfurlsjtuhl	hssmrmluljngtmqh
tjuhsfthippglpth	tllupqffsrfkqurn
tjuhjfuhhppgipth	mumkqkrhpkukguog
puuktunufuqfsjks	njkfugpptkhhgqut
puukmuouguqfnjks	jftlngojmkqoqufk
ssgfnsluhjrkqurj	ksppgiqkkmiiiqpp
ssgfgsmuijrkturj	nlgorrlkqhftfmoq
qtlrtnqfnfgftgjp	skmurplhjoipkqph
qtlrmnpfofgfqgjp	romlmsoljrskimpi
orqhjkrqmtqhojqj	tttthmrhusqihqtk
orqhsksqltqhrjqj	rlouqrnljpruooup
fsgrskmigsuoufqg	ohknntoujpmfflnq
fsgrjklifsuopfqg	okuhnhisqprprufi
hqlqupkfngljrtfg	tukipgnjkjjignkr
hqlqlpjfogljotfg	pgniopfprjsogmfh
musmfnqnulonhnpo	lqgripompfuksntp
musmonpntlonmnpo	htjhfhihtpftkglo
qojfgnlohslirjss	skrhmksqfgsngslp
qojfnnmoisliojss	rjqhmissrknjiigi
ssqongjgojirnmgu	ksqsqitinilfujuk
ssqoggkgnjirsmgu	jgrolikfjlqtmhon
kpnogiqtftnnfhno	rqohottnsoqhhlin
kpnoniptgtnnkhno	jopmpfskoiumnqfm
orjukguttfjuqgkm	riomqfgjkhnipgjf
orjurgttufjutgkm	sikmnppsnkrppsuu
ttitunkfnqrrnorh	sopmjfosnrfotnlu
ttitlnjfoqrrsorh	jpuhhtgriikoppil
itilpmkpuifnfhff	qlstmrmgujlmlulm
itilimjptifnkhff	pkuroghuhsiqmfso
rgqprplgluksiktl	pllnjnrlllqtqtpl
rgqpkpmgmukslktl	pgptqtqngffjrtfs
hsgultrpqqtljlug	oghsoliogqhmougq
hsguutsppqtlglug	irqulfmimtisoint
mnglpjqhsfjfshnh	njpofitoquhrfnpt
mnglijphrfjfnhnh	jjujtgntqlnjlqrj
hptjlfpniplktjqs	sujmmkmhusltqjnj
hptjufqnhplkqjqs	ojoqfkgumfrmojku
mofngskguruonksq	gilsonilufppnrkm
mofnnsjgtruosksq	jfohohmjimlljgrs
posfhkijjiqqgprn	gjoumqlrtloipnri
posfqkhjkiqqjprn	uolllhqhgiikhrjs
psrtpnrlfqttufrq	ktlsqsghupfmsspn
psrtinslgqttpfrq	mntnijjfthhtkljk
jfgpsqsighqukqrh	uoqpihntgqngqnjq
jfgpjqrifhqufqrh	otquprphfhfnufmu
khtukgoolnqtfrnf	slollgkphskorqkp
khturgnomnqtkrnf	ilrsoqsiufmrmrni
jhrrsuportqkrfnm	qhhlofshijhjomot
jhrrjuqostqkofnm	squnitughlhgpjol
jpuhtnnsqksnoojp	fnrkgutulskghqkg
jpuhmnospksnrojp	omkjluqltnirihtu
hhktmssgosruqtfn	kojttqhpprulinqr
hhkttsrgnsruttfn	lfoltrtgnqjikons
jqmpmmkuskqmfmti	omssnsgotlikosgl
jqmptmjurkqmkmti	gugosrijotpkhhgg
ukkhfpkgthnqjljk	srfqjlpusthputsr
ukkhopjguhnqgljk	gkifhrrtftfippml
jqurkjknotmthrfq	qsifjplflohtimor
jqurrjjnntmtmrfq	gqofgjstjkntffkk
lussjglhhntjhqlj	hukljfrtmfmjutol
lusssgmhintjmqlj	rlnqjllqkuntgrsk
mufijnroggtnjjjl	frhrtusogkkpjtfr
mufisnsofgtngjjl	fnjmtuiigrtiolui
ptgkklkifjinpsrs	tfgrqgklrgmhqrim
ptgkrljigjinusrs	mphoknfijkjgsquu
rnjlthgmijjgqluj	gngsofhjqoptqrsn
rnjlmhfmhjjgtluj	ftmqsoiflimjfqkn
oqogsrmspnojsilm	rqttnjsmkghqforl
oqogjrlsqnojnilm	juojmimtolrmuuhu
infittimqtiqjugg	qjlrnsprjtjqnjig
infimthmptiqgugg	sqhgrmufkmhhnrip
kqhsqrmhkstlshko	jguoooqfjijqkolj
kqhshrlhjstlnhko	qrrhnsphriinjojo
mqjuhrqrgsogpqir	firmliojmttfhfog
mqjuqrprfsoguqir	nhqqhphgjusskonh
isokiqkgrrspfmkr	pmprklqrtpriostl
isokpqjgsrspkmkr	nskplkpjpuqhhlfo
trrqostfqmtqlrot	rlnlfkohstkhtipr
trrqfsufpmtqirot	lgloimqmugqqhfrn
pmsjsrqtuktmgoli	hptpgttfrspjssls
pmsjjrpttktmjoli	hlqrkrlgfnlrioun
stuourlokmkqkrqs	rnfmhqmifnqrroji
stuolrmojmkqfrqs	fttggsqfinhrfhrr
lprtikfniipulnrg	itlmlgigthojklrj
lprtpkgnhipuinrg	ipqpqgomtkmqilit
ftpuqpinkqjmhmfg	rnskmnpjukfthgmu
ftpuhphnjqjmmmfg	spsursqjiksmgfgt
jltgqpqjlmijfsgt	rpqulikumtngrffr
jltghppjmmijksgt	jspqrppofrnjgtjm
tqhqokrjjtnlghrr	utggosomfhpmtpup
tqhqfksjktnljhrr	pjrihuifkhnnphrp
uilokutoijssgonl	tfrklpqlugsonttp
uiloruuohjssjonl	ufrorsognlokqknr
quonmnnripouplmn	molplgqonslolfti
quontnorhpouulmn	trtfqfjfkmhmtftf
nikfonjfngsirjgi	tihtgfuofpsfuirp
nikffnkfogsiojgi	rlngtrlfjulokort
ggsmtkthfrriqtns	oqfrtgntfftkgohs
ggsmmkuhgrrittns	piiltljosktfftko
jtgolfokhmjfftip	hllimgrislppohks
jtgoufnkimjfktip	ilmnplrjsgnhfjgg
otjpsshthppooujk	rguqtkkiqoqfphln
otjpjsitipporujk	mgirfsksgsgpuiln
hunmtrmghlhoripj	srunmqmftjnhtupm
hunmmrlgilhooipj	jotoffkkulsqltso
orqgqifnrlmmkqmj	hqniinslsnqumsqr
orqghignslmmfqmj	gimsnpqnnirufnph
irljlktjomulqsgm	oqhgqmproumqruji
irljukujnmultsgm	qgrprropokrqqfkt
tpusplffjfgjjmkk	mmkqnkfrufrorkoo
tpusilgfkfgjgmkk	nrkkffshjpitgnfk
njiklosihumkjmum	rusmqljhfrmnhmlk
njikuoriiumkgmum	jrsrnlqgmrhqhrnf
rsihgtqtsjnnumhj	ssontptqrmknhfto
rsihntptrjnnpmhj	tlkuolgrsmkikpmg
ujojhkqonqsiklfr	rmtgphnkuroqmmik
ujojqkpooqsiflfr	omsjllpfumlugkrm
mrrlnkkfqojhrmgg	mjlstiokiujjquhn
mrrlgkjfpojhomgg	rkksnhfrgsulknoo
pnlslglqtjphnlqj	qjfkkptqkhphlimq
pnlsugmqujphslqj	ouohfqsmogjrlmjs
uhpmnnpogqhtoqsr	plmhtmqrosjnqnsk
uhpmgnqofqhtrqsr	hmilpspsqlsukhnn
kpkmoutqinknfstl	kukmijspfnkjisjo
kpkmfuuqhnknkstl	rhjijgomrmgsqfim
tgloomopsugggqlh	gtkottiuiuiiknqm
tglofmnpruggjqlh	gtopqkhhoqtikmsp
rqfqlloktuhlmnsu	nluoiqotqotluorl
rqfqulnkuuhlhnsu	njnjorqtgnltgspl
hqgnjqfhfptiqofl	pqhqljkjfoiiimkn
hqgnsqghgptitofl	umoliilmjgkisoug
jssqjffutogjqrmf	pgohshokqfjqtjos
jssqsfguuogjtrmf	hqkrooktsshitosf
gnfjmthggoftfskt	iqnhrnqpjrprnjmk
gnfjttigfoftkskt	oqhottkgmqmqoklu
ognhmiqlosumojqs	knoipkupfsjituql
ognhtiplnsumrjqs	iroitfqptlqiigmm
ttnmojurufopjjti	plijjjknsqskutjl
ttnmfjtrtfopgjti	qrsjqfshmsilfttt
fhhkrimuupmlgsgg	rnnssmntgtmqqosu
fhhkkilutpmljsgg	noqjlrfokkrotrso
mmrimnhtrkffotqi	hmnnniotglomsmnt
mmritnitskffrtqi	hkurpprslnrjhspq
kjkltuoqrnulspps	ogoufsrfonqplstg
kjklmunqsnulnpps	ntpjlghljflpgmfj
rfsjptqrgnrrrtjt	qkmrosfltosmmmgh
rfsjitprfnrrotjt	ffillqiuguojtfsu
umsoslusfnnustro	ounssgjkgpohjqju
umsojltsgnnuntro	ostlrljqnqnhgkst
kngutkghsoulouil	luqltpmmggkrguti
kngumkfhroulruil	lqhqugrloqknjmpn
utgllshlnorgkmnu	kgpmrlporifmnsni
utglusiloorgfmnu	kiqhfunshsunmqnj
hmhsnlfumjiiomfo	ftfojktqnifofttr
hmhsglguljiirmfo	uqgjhjnlurtggmjf
ritfojnspnqpkqss	qrolokqrtsugrfoo
ritffjosqnqpfqss	uhnruhhhunugrlfg
lpqfgujpqtmmugoi	loqumhqfikkgkuqo
lpqfnukpptmmpgoi	ouqtufponkptohpg
ptnmojtkrgnflnno	pjqkrjrnsgtophps
ptnmfjuksgnfinno	fniqmgoqofjkoifn
homqjskpopqosqjm	npolmghqjfhsnnsg
homqssjpnpqonqjm	plpoirmpnmmlhuuq
ghnrjrmqmlgiiump	houfjjjrnflfmsjr
ghnrsrlqllgilump	jifologutuupulql
rfrusjfitjjrtsqj	pootmirsllllklll
rfrujjgiujjrqsqj	huttrlukprgsopln
sksklhphonughgou	prgskotjnikpigsj
skskuhqhnnugmgou	ssgfiopnmgigmrif
qjssjttkthkknouq	lolthmkntfuimrjj
qjssstukuhkksouq	gostikljnoikilft
tlhmlufuhfrhujkj	qqtspptqisokqpfu
tlhmuuguifrhpjkj	hglpnmghktjmkqpl
jghujkrnjqgqjhpu	rhmngnmfiprhfjgr
jghusksnkqgqghpu	oupikqrlfqontggi
mgtnmhuuurimpsru	qrikmpiuptfhohnr
mgtnthtutrimusru	otgfontupqjhplso
fqhjlpjohuujhjri	qhksglnnogqjthjl
fqhjupkoiuujmjri	jtmrtrtguqfjpifh
rlqfuphpmsuitoif	luquoljiiguhtjlu
rlqflpiplsuiqoif	fjqjtiutpflokmhq
rmooilmimghtrkhs	psmtgmqisjhqfuku
rmoopllilghtokhs	pjgfofklkmkhlitl
gmjlipopuipmthls	grgkjkmmmglgfhus
gmjlppnptipmqhls	pnhqtiijgoorqpno
jglopsnpstpkpqhu	jiqplqngpolgurjt
jgloisoprtpkuqhu	upqkqljpitnnhjus
gfgtkqkoklsrqkmo	rnmrqjkskmusfiqm
gfgtrqjojlsrtkmo	llpqqnuthshtjjro
rjqspnijmkjjgkls	prmkgksksqpqljts
rjqsinhjlkjjjkls	tugsgpnkjpiurmol
ffgpunupnstqsslr	ssgpmrulfgrqftfs
ffgplntpostqnslr	mtssguiosshihsts
mqonmrlogiumkopk	qfupppormoffopsp
mqontrmofiumfopk	gjnqhfnkffktiglo
tloifhlqplpgjlls	gnsunrusorrflfnr
tloiohmqqlpgglls	pirfqrrsmslfmmpi
hhigjpjmnnlkgmin	offumuiujiruhsmr
hhigspkmonlkjmin	jfmigkmtggrhfihn
ifklnskrinmqmkqu	rrjsspushgulpuph
ifklgsjrhnmqhkqu	ikmjplkffsmhtjqn
monfjnsruiglmuqq	igmttnjrqsjnfojk
monfsnrrtiglhuqq	ollimsqoqkptsksg
gsifomnkngkgjppf	urhlkhnjpqiujtpm
gsiffmokogkggppf	rijsfpmjkghgqppg
niklkopgsqthgpou	igqtughomuqmpulm
niklroqgrqthjpou	qqtliutqnohrrufi
moprstrngjugqnik	pflorpqmfsgpohfq
moprjtsnfjugtnik	piomfutjikrmofkj
lrjfkljrkfqqhhpl	utplprsoupnssomm
lrjfrlkrjfqqmhpl	qfjrjhjgtsgrpnqn
mktpgftfgtolignp	gmlksmmsntfnlggp
mktpnfufftollgnp	fiihqmhkotjtijfr
qophlunpjklrrmhq	priopjothgkhongm
qophuuopkklromhq	trpqmosiqslnnroi
piuqgqqlthlrqjtr	fqlilpfukjpnmnil
piuqnqpluhlrtjtr	suhtmtrntirkkrtg
gonjjnqlsrrrmuki	piisspghjqqfhtpi
gonjsnplrrrrhuki	jprssfuumjjkfuok
