qhkiilntiofptrjl	mmonrsuqojufilrp
qhkiitnuiogptrjl	jjkqoomqfnsltpqg
srojsfgmqkqffukh	snsupslssqothjnj
srojsnglqkpffukh	uqrprulfnjgqohkn
gsqmhrjqmgthgoiu	sqlfgifosljlspgr
gsqmhjjpmguhgoiu	umpkqqlsjrttsugt
onrhiilsjkmojohn	gnhlmnrpghfflppm
onrhiqlrjklojohn	lskrgulrhpmqglff
nkgrflsmuhqkmuig	tmfomjrtsnhotflg
nkgrftsluhpkmuig	ptrithlpnufifont
tktskunorojpopfk	pljnjntnqmqulnmq
tktskmnnrokpopfk	lhlhmgfmgiurpufn
hnriooskmjmjpsgo	qngfmpsosjflfhmm
hnriogsjmjljpsgo	lltqfmggqlrhkmfo
nrmrlgmniqshmhrf	sklujtljffpfhtig
nrmrlomoiqrhmhrf	mimkjlgkgokrkkrq
mpiuhgltutnqpmsl	gjlkfmmnglikfpsr
mpiuholuutoqpmsl	ksltuglgrmqrtufj
klftunjphsjlhuio	snspouhglgoslomg
klftufjqhsklhuio	qingothsosgslhgq
knrltkpmopmojjnk	qfllngllpupgoqst
knrltsploplojjnk	ugosnljsfptkjqkh
nslrfmrkulqfjspt	fjposqmqfuktuplk
nslrfurjulpfjspt	pqfjmufoikiionqh
ujsrlfltmkqjqkmu	rosqtsfijuggmlmk
ujsrlnlumkpjqkmu	sttipspmiujktrsf
shoiluuuhhrglmlg	qnuqqgfkjqflguir
shoilmuthhsglmlg	rrmigfoiooqritik
ipmlrfijmgpjunhh	srifsujsrtomnosr
ipmlrnikmgqjunhh	qqotsmmtngimkqpu
rnoooijlutnkiomi	fotlommuqotfkiit
rnoooqjmutokiomi	kttgqptolihuunpm
fhngpjfqhplfhtok	srmqpopnnjpptjgj
fhngprfphpmfhtok	ktshruskrtikrnkj
kqsjtthfkmulflik	funjgktqjlohlqlt
kqsjtlhgkmtlflik	slmktooqttpmsuqg
gntgonkrtqhkjtis	lkotljfojqfqnpgm
gntgofkstqikjtis	ompufpoffimlhfkt
pljimiuftqlrjsnm	kfkfjnglojlrjihp
pljimqugtqmrjsnm	qljnttuqnsknnkpp
okfrjhiftlgpfioq	rphsnorofifkmlus
okfrjpigtlfpfioq	tktnrqqntnjhojrp
kflouipsuimgfklp	onnsqnjmukgsnmln
kflouqpruilgfklp	lnfpimtjkgfsimth
tmjiilrmskuuuktp	gprigrfnopfumkrn
tmjiitrlsktuuktp	fupofltkqfluphqm
psmspfggniiukfmg	opnoifqsjrsjntnr
psmspngfnihukfmg	ofqsnijklluspntj
fplfolkjimhllitj	frropijlfrnnshst
fplfotkkimillitj	uihllhnkophrnjom
jnrgqorjmnloqhkl	jqifqhsnpiknqtoo
jnrgqgrkmnmoqhkl	hripjgorfnurljos
smrlknpmhpjtojli	qplmuggpqsjfifqi
smrlkfplhpktojli	kjtnrougfjkfmmtj
gqonlgqpprorjqsm	sqjqkurnqhhfuqml
gqonloqqprnrjqsm	uiqhqqjshunloljt
siupuqqftikuriuj	phqtpnihrrlutrfl
siupuiqgtijuriuj	fshuktiknlpjlsnt
kgjmpjkkqjuhqsfl	illnpjpqgojgoumu
kgjmprkjqjthqsfl	mnqtspqisrolfsrh
opuskfjihfhkgrgk	rfspsnkootofogrl
opusknjhhfikgrgk	qshriklinhuktpkn
opnrnsfooigjrugj	ptljggiqusqsingf
opnrnkfnoifjrugj	fmkrjggrgsjturis
qfrtoppnhffhuihi	fnjpmpjsnfnmhsgt
qfrtohpohfghuihi	lupsmmjkqootqrmu
fiflmolmitlqqlnr	sntosjpffqjhulgl
fiflmgllitmqqlnr	nupomfnmlfjpgrfp
qhrnuqptfgloosqf	jlknnoqgqtqqftng
qhrnuipufgmoosqf	mmtnmgplfpkjknis
mpirphpspkpqnmon	ifkjtgjhqpqghlto
mpirppprpkqqnmon	mtuqrtppkstlnfhp
fmmngiipkqgqmmfi	huhogqqmqmujrtgf
fmmngqiqkqfqmmfi	sotlohhoipultjlr
tthfjnotrqfgguoq	nlknqjkprhkggnrq
tthfjfourqggguoq	nnkgimhnmuhmiqfu
ghppqhjuukkpjqpq	fpjnoqkfhuolmqon
ghppqpjtukjpjqpq	mooqfujonniplngs
nprnloolhnitomjp	qmlpjphspmkrpnsi
nprnlgomhnhtomjp	pnrmjnoglsflipkm
ihklrskknhqggltr	oisqsslpstituifg
ihklrkkjnhpggltr	ogiqsnoqsihjuuqi
lgjjitulqlloqufu	rminhhfuujrsotkr
lgjjilumqlmoqufu	rqgsglstshqfotuq
nrkpqhjtggklkrhg	kqioqnohmlfqfgjp
nrkpqpjuggjlkrhg	tqhqlunslihssjlh
lotgsjhkkngtqjmq	ofkfhhogonntmupj
lotgsrhjknftqjmq	omumipguqgokmrfr
ljgfmgnsjsimnioj	ktpnrnknfjntuouo
ljgfmonrjshmnioj	upsrlfipikrnlihn
mjljuthphqopfpmr	insjfjorfqnmllrg
mjljulhqhqnpfpmr	mhjihsjqposqhtuh
gshjhgsfljslksfk	jjlnghfmhoinrogg
gshjhosgljrlksfk	nsiqthpjpfuupmiq
sjogltlkkmqrfgoq	mlitrgfrpipujrhq
sjogllljkmprfgoq	kulkkkrgsphqnuih
jkjsfogohrmtfnhf	stutrgrfqntrmfgq
jkjsfggnhrltfnhf	pkotsusjgillhnns
rfnhujmolriururk	kiihrkhfhgtfqjmg
rfnhurmnlrhururk	rggrpolqgtkljpnq
nojpguomuoplsktk	mntrpkunitgqiigo
nojpgmoluoqlsktk	lrlmgiphmfnphjug
tooiompjmqujtmfk	rfkmrhsprfhuhlrf
tooioupkmqtjtmfk	ujthqiishjqtfuki
nnuiokhugrtsgohq	mkgpjoggpnrjjosm
nnuioshtgrusgohq	jhflmqgnktgqshoi
juprttkkloofpfgf	msjqrrfhmqnugsuj
juprtlkjlonfpfgf	hmltutqfosmppimm
msigfnfohmkrkgho	sokriglhgjqlotft
msigfffnhmjrkgho	mrgtsmujfhimhikh
orfpllgihgufqtrl	qrmfrrhpttlfqkmf
orfpltghhgtfqtrl	sqmkqhhhmisuktjh
rugimuothhrgjrhs	huikgqqlljrmgmts
rugimmouhhsgjrhs	ngkjusrgfirliolh
jmmgfuptjsgrfluq	hkojuumpopfgtrij
jmmgfmpujsfrfluq	iipptoqquqpgfofr
fskonkrionmsjqtr	tsmlqkooppugnisp
fskonsrhonlsjqtr	ufqhjgoghlksnjph
jnolofnonuuigjqs	lmuoqtqofhrqgnpn
jnolonnnnutigjqs	kjljqlmnusgothik
imrkmknrpumurqnj	lmglmrgpoqjonutj
imrkmsnspulurqnj	nfshrjimkoilghtf
irqqjhqmglolhrmp	nroukimpknlmikmp
irqqjpqlglnlhrmp	rnnqsjosfjkqtifm
ngutkhhtppqufuri	lqmqnksmuurhhfqi
ngutkphupppufuri	jjlhsgjmnjtsqskh
rququntsjhmsnktg	uonpfksmtmqnsqhn
rququftrjhlsnktg	foqtjlgirupujthj
ugipngsggjsptpgn	ljgqjquqttojfruo
ugipnosfgjrptpgn	fignfthromffrkrn
ilnmqmnknupiitls	pnorforqhfqhlfon
ilnmqunjnuqiitls	iolmopltonopiiio
guiplhlrikqlnfhn	nilpifuumslfumpt
guiplplsikplnfhn	npoohprosplqfkql
lmhpmmqmuhlmugfg	ijutlhhgtphrhtup
lmhpmuqluhmmugfg	pkuqrhjpnsitottt
spqqptipqmnnittm	iuitqjjqljgfpjpm
spqqpliqqmonittm	ihgnmrtkkhlimrti
lliigslfjnltifgf	jupiugkjhgqlmlof
lliigklgjnmtifgf	psnfjrnirnfqgmim
kiftmqimmslgofku	rptuuulnlnjjijnq
kiftmiilmsmgofku	jkiksmtnoistrshp
hffklotfgnornsip	gnpojguopgtjpkpi
hffklgtggnnrnsip	tohitouhnsrrntqi
qfuiojuimkiqfugm	oifothonqflpstkt
qfuioruhmkhqfugm	jhgplplmfrjklrjg
joskpolqpolqhhnq	ssppsifjtjuojqui
joskpglppomqhhnq	gktqqfhqhhjlkrmi
phkmolotqmjsomsl	pktknpthjgqufnrl
phkmotouqmksomsl	kiojhilkqnjlhuuo
pkphjmipikgksslt	lgfgnrgquqhjifuf
pkphjuiqikfksslt	pmrqsgfslhoftprf
hftikjrkrinpmsos	lhtlqriutpqkunqr
hftikrrjriopmsos	mhntopfurhsrfhtr
qiguofuuktsnufrr	lffpronojptgfsto
qiguonutktrnufrr	mgrirmijtnuqjhqk
quglqnnrrqiumrhj	htitsmpjhjhggmhk
quglqfnsrqhumrhj	rkthuhoqgqgmngoh
gghhmgoknpqkmjoj	kmpksunnrksnutus
gghhmoojnppkmjoj	mphrrliujijokohg
fshrlusmnggrgiog	ujktnfuponhkgufu
fshrlmslngfrgiog	pijplljghopkrtki
gutltgmtqqrhhtlo	srnrkjirtgrmkjsk
gutltomuqqshhtlo	qpqksukioshtimhj
mknpkntqpnkohpit	phqpuimnjqgkhsqu
mknpkftppnjohpit	nuqnpnoilqnphtlq
fshfupsrlpjpfpgq	tkmpumnsffugjuls
fshfuhsslpkpfpgq	nuktjunmmltkpluj
thihfjfijjtinkkj	rklkijpflqstofti
thihfrfhjjuinkkj	jhptfusphjuskokm
tktrpslfulugosjs	ngqlmpoksmnsqrlp
tktrpklgultgosjs	inilpnnpkjskjohn
itifgrhffrtqksfr	tstlrsutuolnokus
itifgjhgfruqksfr	piuiloiphgkgkojm
jgjtfuuljiligpkj	kmhhltkonjkpmulg
jgjtfmumjimigpkj	psurpuriqtnluqqk
llmtshmhugqjsopi	kmqnkrpkkpoojfrh
llmtspmiugpjsopi	prkktokhhkmnislh
qppfklfimjsjqhks	gghkuqffilprjggq
qppfktfhmjrjqhks	hiprrumjunmthoif
osfhlrsrjjoitosk	rgggrjhutpkhrgpq
osfhljssjjnitosk	uqlgglimnkrooofg
lkuisrhonlsqiqlt	rhjmhkljnrkjnpgm
lkuisjhnnlrqiqlt	rhrkkfnphjfupjuh
sjmuqjjsktssjmjr	ggprfmnnmpjmrffl
sjmuqrjrktrsjmjr	pspousunjqrpfssi
umgpnourftnphikg	irtommmsqiphqnqr
umgpngusftophikg	puoljurlpsomurfn
suufikmnigjfogui	tfqngfhhlltusphn
suufismoigkfogui	iquogtklnhioqoll
itloqhnfjgrtlhtf	poopifujsqsqkntt
itloqpngjgstlhtf	jhtfrtimqrrnkufl
kqqkltuqjutnphlm	prssmgsjqmhumsho
kqqkllupjuunphlm	muninsptgfhjkhhl
iugpuuuonsmufhfg	rmosmfmpofrulipk
iugpumunnslufhfg	kojkkmukrtmpnimi
pgiuthrplplngfsi	oirsqsgrjthortsr
pgiutprqlpmngfsi	onnpmltnqhptripq
irgsqihhmtgijrrk	usksuirokjfgppin
irgsqqhimtfijrrk	ffsqurgsjuutttqg
sgmlmqtqstslknsu	unpukhknfuisujli
sgmlmitpstrlknsu	junmhuftujnsikfr
oqtrmlotnsklmuoo	gnjslhuprsgumgrf
oqtrmtounsjlmuoo	qjhgqprohujuglkr
tpurfhqrisfqksrg	ohgnmqouitulhgrp
tpurfpqsisgqksrg	nulhrklghhrflqls
qmljqlkmkuthrgku	pjqpurgurkfukjqm
qmljqtklkuuhrgku	quprlqipjprlgupt
mposifsninkfhrro	ulpjmjqmspjjgnpt
mposinsoinjfhrro	tjmjglmllqonoght
rsgrfklslffusjuo	hontqjlkrrrmjnml
rsgrfslrlfgusjuo	mugjkjplofrmrull
jqmnfimkpkuohkkq	gflnkolqishskojj
jqmnfqmjpktohkkq	mrknmrljrkmfkshf
uohistmjqskksjhj	lsoqnlfqjphfgfpo
uohislmkqsjksjhj	hsuipijqinqrnoig
rilrioftikgifssg	pgfonmthsmmmskpl
rilrigfuikfifssg	gupnrrfqlpkouqil
hjpiijponnijofrf	nmkukihjnhrhgkkl
hjpiirpnnnhjofrf	flhgjguomtptpslf
rtroqqmjjluihkls	rjuqpihitiutthqn
rtroqimkjltihkls	foskfqkkgninnoht
knqlpftgmjphptuf	prrnrimnrpofgqrq
knqlpntfmjqhptuf	iohphnfnmjnngumq
pqrhjgggoupplrpg	nrgoqggokqftfqgf
pqrhjogfouqplrpg	sotutokprsguqipk
lgipolhtjokkfgjo	nmspljkhlftnsrst
lgipothujojkfgjo	ffqukkjllqhthkjs
gfrlfjktmhoqlrjn	oqlihgmmtompsfou
gfrlfrkumhnqlrjn	kspghstmkosjlpmn
stpfquokmfqsoutl	sghmoqhiffpkftfm
stpfqmojmfpsoutl	sosithiliusnnfri
jqmtrrhkuoikqikj	kjlghtnkfshfkgih
jqmtrjhjuohkqikj	tutgpsmqnqognhsq
frfipjoromuunjpg	ogfpurlfiugorior
frfiprosomtunjpg	fugqmijnltkpuuqs
pmoikpjspmsohrfk	flfmuqgnurpoitgk
pmoikhjrpmrohrfk	fmkktqnnsrrqftuj
nhpuonigofglhpqt	mgkofrnfnfofsfhg
nhpuofifofflhpqt	hglqukgqgimursum
jopiijrkfghqmmhn	mflnnfjipsogonnt
jopiirrjfgiqmmhn	shkklkgpiptjisst
ufonsjkikgiotsqh	kqtumunmfljshjuu
ufonsrkhkghotsqh	oqtiothjqripgpkg
uujqifqogqrnfotu	uolshkjqgilmgpqp
uujqinqngqsnfotu	qrmkipknrohrkftf
tnljrsfnfonnpuoq	kgoukqnjhshflorl
tnljrkfofoonpuoq	hpqmqpnjhhnhkikr
infthtgqlpstqoqt	lriupgirljjpsrjq
infthlgplprtqoqt	uinuqrskohmlqisk
fsnnsntgkgsqspgh	siufirnigfuptunf
fsnnsftfkgrqspgh	qmtgsothitsulpgo
kkiotiokppkintgp	jukkufnggfrlhuqi
kkiotqojppjintgp	sllourikqjfhkiur
nnjjtuhfrgpfkgui	iortnjnitiqsmqri
nnjjtmhgrgqfkgui	lhqkjthktgskotps
lqtqqliqinpuhiuj	juklknopjlojhlrl
lqtqqtipinquhiuj	usfogmgqhtrmsgts
pkkguosurshfplqh	ouhjgjifgsjpufjj
pkkgugstrsifplqh	noksohgkmusrjris
itqnhpmrqotnpisg	rqmrjsniurhlnros
itqnhhmsqounpisg	llkhfpilrlgnpjnj
rsughhjhrhfmosnq	irglunoroltigsnn
rsughpjirhgmosnq	kqpqhlqnifrskfnq
qkofqsnfspiilugh	rihjsigqilsgqtfp
qkofqkngsphilugh	lfunosotpklpgpon
lqfpshpjjsgrnjgs	njmuorrptitigijp
lqfpsppkjsfrnjgs	rhfgrniiqossiimi
ikjlnlgkqjoohjhr	ioksmrkhiflohoko
ikjlntgjqjnohjhr	hlgffmkfqnjfhpru
gntulhhunuutkmhf	lkrssrotmfjopotp
gntulphtnuttkmhf	hqknkthuouhlpqmk
smukklrsjlohfkrt	ofitqumjijnfkffj
smukktrrjlnhfkrt	rpnqorotjspnunno
nnkqkukgqsqjqjth	loiqighopfoqskgo
nnkqkmkfqspjqjth	klohmttjoispppfg
frrojpinmqjrsqjh	rogillngprmjkpgp
frrojhiomqkrsqjh	ljsoiqkupttnnhif
lrrniprfkooqnhhp	pfspkhkmkpkfhnop
lrrnihrgkonqnhhp	gnhonufugmommpgj
sujhfturoqkjlnki	rsmmjrrlttlqmrrs
sujhflusoqjjlnki	mtmtshlisifuipuj
kusggkktlukulfns	tfpolmorfhooshjm
kusggskulujulfns	kusungsqsntqstln
lottuimogonustsq	gtmnllufhllgqgqk
lottuqmngooustsq	nglroohtprnoskpm
iormsrjintugghlj	rlugppijuhpgrgsp
iormsjjhnttgghlj	ttfniqqqsuqojqjl
ggqlmohofsjrgfnu	snstgisrkoumhmsm
ggqlmghnfskrgfnu	snkrrrighlhggtgh
rguiuffignjsfphf	ungfpllipjhfilpl
rguiunfhgnksfphf	hprmlqthhfuqmjkr
plshpripfjfhjlkl	lgirqrklrktultru
plshpjiqfjghjlkl	uituurmtrjnithtu
lumilhulfrshohqp	tjqkpsmrnfglunph
lumilpumfrrhohqp	nmsjrjglrumrrhju
uhfsrpnoufplqgnm	opnnpruinlkkhiof
uhfsrhnnufqlqgnm	kssirjokntgjiuli
prsphjpfojfpplnu	quqlijgtrkrmugpo
prsphrpgojgpplnu	rliskpgpjojmrmoo
tluiflfsmrtginui	kuofpgnmlmuksjki
tluiftfrmruginui	topjfffmksllhjkq
kmmirktqigjultlh	knphfsqghjstnrjh
kmmirstpigkultlh	gqthtjpkogomqfjq
krstgqggfnfsqlit	mmkgptspnglkujgn
krstgigffngsqlit	tslgmflfmmftqhop
fppqfspusrlogprh	ppumiftlhfrnhpts
fppqfkptsrmogprh	qlhqqjqhpmrqustl
nmsogjfjsmpurlft	qiofstrmkhogpmjh
nmsogrfksmqurlft	uutogprgriskosni
krptrkptqtkjtkiq	uijuqpopporqjspp
krptrspuqtjjtkiq	fggtruornslgsjis
ipiiqnjoqhqffsnf	ifsfrnimpmphgsnh
ipiiqfjnqhpffsnf	uhihthnqkqrhpkjp
mnrguhkorpsnhttt	skthogkfpkimqikh
mnrgupknrprnhttt	oqujortfqqimlnhf
spigoukgiiggpglh	qsghmpigmmqpfhfm
spigomkfiifgpglh	mgskihfhgjugsgtk
grntiljufnrgnmgu	nffrtqrfhmktjhpp
grntitjtfnsgnmgu	snfiifqshttpiqqk
jppurpkonosufrrs	krqmrjolnuonjiks
jppurhknnorufrrs	ohmtnqlqiqmgniro
tgqonfjokfiptljq	lpknignrnkmfsitm
tgqonnjnkfhptljq	inkkmkunfnhjilmu
iulifsqngpthorjm	spgiunsjpltjuqpm
iulifkqogpuhorjm	rpfqsfipofgrtkqt
gniqiuiirrholitf	tilurfmmtilsqrlm
gniqimihrriolitf	oklottfnfuoqmlmu
qokqjmiqjsqoknpl	ssjgmjpljftsohtr
qokqjuipjspoknpl	lrrsofrotqijqnul
koqtrlfprlttjkkm	oulrltnfkpmmqqku
koqtrtfqrlutjkkm	hqusthliruhfmrlk
ujshpmqpjpfnhjrm	nhjigpprutmiglrs
ujshpuqqjpgnhjrm	ptsssgrfqkjpfpkk
qguusltphtfukkqg	qsfrrqhqupphmrru
qguusttqhtgukkqg	prujsimqghmornlo
foiujssfotqiflrn	fflqojthmtmfmtqm
foiujksgotpiflrn	ropkouqiipusrnhn
lflumhqrstothgut	ujjlngrqltjhhtot
lflumpqsstnthgut	pijkugussimmhprl
sutfofukhlqgfupj	pqhkggmqljiorgtt
sutfonujhlpgfupj	nstkonjiinrfnhrs
uuoirjhjulhqjusu	osqhtkqppkmpokut
uuoirrhkuliqjusu	gpsnjnfhujgrpnqm
smtsjpgihiqlfpgk	ffpsmiignkugnnmn
smtsjhghhiplfpgk	lmihuupngruururp
fijltoqgurnlmkqs	fqptjuusfqlgqlfq
fijltgqfurolmkqs	sqlpluilikqhmrjq
ufulrlhtfjtfigih	umsokhllkijhigkr
ufulrthufjufigih	ijrgjposkjiqgopk
ttmnrpgknphikimg	ffkhokprltulqqjp
ttmnrhgjnpiikimg	jmnrskoulrtujfru
gmfufmmmjmgrgmjm	nhhqfojsipophnrr
gmfufumljmfrgmjm	phuslffhnksoipsl
hoqoomltouqhhiuj	sqgskslsolnqilmn
hoqoouluouphhiuj	jktsmqnsofokqson
utrgqpjsqlkirkot	flgmflkirljhonim
utrgqhjrqljirkot	qrkrglnjnupsngqk
rsopfqjtlgkklsjt	rlljrggsgokohlrl
rsopfijulgjklsjt	oslfktstgljrrmgg
qprqqfjmjihfnnif	qftjtklhigqiispg
qprqqnjljiifnnif	komsrnrkjpimqnoj
jjmjgfhfsuhsoums	ngikksksirmmihhf
jjmjgnhgsuisoums	uisnijnuhnqkitnq
mnsqquiqspujkrqh	untjshrriotsqlfn
mnsqqmipsptjkrqh	rrlltttqnplhugfk
fofhqsfpqkqqjopg	songqnookmkofplr
fofhqkfqqkpqjopg	ontkjkusliqikqlg
thmfqqhqiilufjjh	rkrfsgtitfsristg
thmfqihpiimufjjh	jsfppskirtmgjitm
fmmghihpqppjgmug	irshmroinnopuftj
fmmghqhqqpqjgmug	jjmqfgkigljiuosf
qgkipflqjiqkhnug	rjsrksqpjrusmhku
qgkipnlpjipkhnug	pmphkurlfmpulluh
glontukquqthunhk	fkutpkkqqjrqltjt
glontmkpuquhunhk	moqnrrnnkukmmftq
klhiuiikgqutiogh	nkolfmholpuikuht
klhiuqijgqttiogh	rrsfsklropkopgsr
rrgsijsiphqtlufg	thihqqqogkgnptut
rrgsirshphptlufg	ohpgjpthijuupqhj
kusqkmtpggosuugn	lnlijghqgfsluklj
kusqkutqggnsuugn	hfgttfrnsttsgrsp
oikojktkojpqsioi	rsiqifionlfgllpg
oikojstjojqqsioi	qfuphmgfhqqmjsfr
ptusifnntpijhsok	frkrkqsgplfprnpf
ptusinnotphjhsok	nfmiftupqpsgouuq
lmihfirgoqtpioip	fkhlglujssutkpjr
lmihfqrfoqupioip	lslosoitlfistfku
rosqkmpltnufktll	gqfhujtkhkhlkmlm
rosqkupmtntfktll	pukuhshlggjpjujh
ttfsjgumkgijmkju	krffhmupuhhsptmi
ttfsjoulkghjmkju	sgmtrhnouqpohohs
ghmmhhqfosqrkuii	gmuputjqpppighgr
ghmmhpqgosprkuii	ngrjqiktormolpru
nusmuqhkrkfokgnl	nsnjjtmrrnhfrihr
nusmuihjrkgokgnl	himsjhtimjlksufh
tifhukoqtnsgtpsi	gitrfkiojqhfhffu
tifhusoptnrgtpsi	siuhgtunjqhrftpu
gnfjkhqhujorhomg	ohhtsfrslrrikhnh
gnfjkpqiujnrhomg	rulkoqkiipsfssgm
oqpkjtnkurffuknl	jnmirmnmijtfhgps
oqpkjlnjurgfuknl	gjtsnfqhtoojlsku
lhrghqkjkltgorgp	iotmggnulrjirsmg
lhrghikkklugorgp	nnrqgjgggpligijf
khujliqlppfrphmq	lhqtoinptjquiikl
khujlqqmppgrphmq	ulijnrsfkogmjstq
fmjjfqipuumjljjm	kmlkugissunnnism
fmjjfiiquuljljjm	olotrmgiumqpfgng
irugurggglkltfij	kplljtkrorrtskri
irugujgfgljltfij	umtqftgjkuhpgsph
qhujjkrqrjqpkfim	tfjifqoosrffimgr
qhujjsrprjppkfim	rtluugpfngghognu
itujoklronpoflgg	jrptutokukkkuppq
itujoslsonqoflgg	njosolksphknrgqg
nkfgihunplmooorm	nfkmuqkirfrjolsm
nkfgipuopllooorm	nrnoslrfqoqptiro
rgfkolhkuftffikp	hjoosgpqhgstninp
rgfkothjufuffikp	qsgooguhjjokqujf
slrutnkmlrhnisph	jgunrmjspgfkqufu
slrutfkllrinisph	ijokriikoqhikokl
jqsufrlnokruqnpr	kgntrhlrttlnghhi
jqsufjlooksuqnpr	nfmoktjuotkommmq
utshtsiiroruiirs	stgokmqrhpnumurg
utshtkihrosuiirs	loffgtkknhiugfmm
fgonmlqitinlgkhi	tmglqkpulufhjllo
fgonmtqhtiolgkhi	ltmtftftiorguugq
jssjqlqjfsohiokt	tihkpqkjgpfhoish
jssjqtqkfsnhiokt	rlqimhlfrojtlnph
sulorlpkkpoltpgj	kjrogjqqlmkkgpit
sulortpjkpnltpgj	niolhtkqrgnphqup
rohhlnngoomoljqp	shjrsguujriltfkm
rohhlfnfoololjqp	rsqlrgtirrfoupqq
khrnsktmurojqugq	mthrumiplrjtihtk
khrnsstlurnjqugq	ukthhiplflkfqlql
rrsstjijfhkqtfri	kortrshjqjmlquoo
rrsstrikfhjqtfri	ujuupnmopolrrioh
lkigqjtnrlolishl	rusukknhrtmkijsn
lkigqrtorlnlishl	inshfmqrmjlplhnu
nitjrkhqshonsifu	nflktipftghqnjmr
nitjrshpshnnsifu	munqtfrhrofjjpjo
hrlfuksmfhfgmshg	srlntokgkqghkjhg
hrlfusslfhggmshg	kkfkhghqrftkmsfr
utgmfghhookhuumj	mtijrtkfkjjrglgt
utgmfohioojhuumj	trmtgoohqopjigiu
nohqmqhsrkojtolg	jqpqspmnonsiqosf
nohqmihrrknjtolg	mktqfhrrjirurkmf
jolissohrrfhhsot	irhiliqghiplfoio
joliskoirrghhsot	gjpllopjuooqugls
pfjqjljqhjojouoh	nkpqjiuhmlmihoul
pfjqjtjphjnjouoh	jrnuitosqqthsrhf
msukhnrtsqiotiqj	mqjrnqgulorslqth
msukhfrusqhotiqj	hlhknqruiffptjhs
rguifljlkomkhrmh	gglmgjsrnslsgrgt
rguiftjmkolkhrmh	qfkuiggpqossrrst
ttofhopqotjrttih	kmirlkrjpkhulohh
ttofhgppotkrttih	sonnsimkfjptspqu
jkrrkgomuujqqqfj	jmqrppnljuglsgti
jkrrkooluukqqqfj	pklonufifqihlntr
jtpmktffikllhsgn	oiglofsoglogrgjq
jtpmklfgikmlhsgn	jrrmrgihqstpnoou
mjlhqmrrnqolrpml	inkkmskilqkqmrsk
mjlhqursnqnlrpml	iugjpsnsjntusjut
jqmuimijhqqpuqni	nftrgfisulhtrhno
jqmuiuikhqppuqni	jhjshiqsnqjurnii
ftojpfugglofognm	oksikiqptirjpfkq
ftojpnufglnfognm	ohijpfjsrnlkkqli
slhutjlffqtthnho	gpitmqsrfjflkpps
slhutrlgfquthnho	rnjllpjpppnmhokj
lknnkqotqjqffsuh	kpsrqsqtuinffmlo
lknnkiouqjpffsuh	tkhqkmnrnmlfgkst
njufftitipmsotkn	iuprroonujftjrht
njuffliuiplsotkn	gikigpljnngrstjr
gqprprshllqfmnqn	kirsjjlpmfqrojgn
gqprpjsillpfmnqn	pljktjstrpmnrklj
oqgjpjtgglmhhnoj	qhgogmlnqtuhotmq
oqgjprtfgllhhnoj	sjglkluiushiqpfl
ssfljqkuinphimpr	ukmfumrplfgptngp
ssfljiktinqhimpr	mqkkpougstquflsh
qofpfuukumujpsmp	ftlimrgrkmmrlkgm
qofpfmujumtjpsmp	nrtuuojrpornimht
sknkluosujgfjtfn	lotfitrhikriitli
sknklmorujffjtfn	fimnfhqmlnkmsgir
lsjmnqnositgpipr	lkfrofopkjpplnur
lsjmninnsiugpipr	jfthuthtnmjqshhr
hinmnqhfnfjiulgn	omilghgrsjjqsspo
hinmnihgnfkiulgn	fuhmhqrpqqhfjijm
pqpsljtnfqhshlng	tfogjpfjosgshquh
pqpslrtofqishlng	ofqtimsqjnrmknif
kqojirilhijuotpj	imppmsuguiokljsr
kqojijimhikuotpj	nlrpuiulpijkspnj
pgftpkprqmlsuhhr	sjistfqrssshhujs
pgftpspsqmmsuhhr	skqkiqmkphrinujl
snhqijpfuqhljhks	hrlqtjqutmkfigss
snhqirpguqiljhks	fklthomohkiqpknn
kkopphqktgukulnf	ttstrkkkoqpqlglh
kkopppqjtgtkulnf	hokltigrpfglhftu
smmtluunfossfupn	qkrrnijptrtfolln
smmtlmuoforsfupn	fkmgorkumqhkhlkk
oiqrtnknnpptjjtu	rfnjusqgjsiqkqjl
oiqrtfkonpqtjjtu	qnlfgmnlhusojfnn
kkhgsisuummhpgiq	uuiuflrhrnrotohs
kkhgsqstumlhpgiq	mroklsjgnfnnrprk
unmkrkhrmmqknlnu	oiifupjrlthpjhhs
unmkrshsmmpknlnu	fgfohkmjhiopthpt
kukgnhnhqnhptlll	lrkujqggqhqhoism
kukgnpniqniptlll	pnkohnmlhqtgosif
ggmnqmjpogkpugpn	gkhrhmitstkorous
ggmnqujqogjpugpn	gfhfiphqoqtfjluh
iphnrirpunpmikmn	grjqkslrpkthrgnq
iphnrqrqunqmikmn	iknruofmrrutuull
porrujhojokomrhg	fgkosqslhtgkkqiq
porrurhnjojomrhg	sgkmumgrglitmqsu
gqtmhqgifhnkfilu	ismusqkksfkfktfp
gqtmhighfhokfilu	knguuplrsgkhojll
ogghtrftpskfumrk	ruqkngppnisrnlpm
ogghtjfupsjfumrk	iflhlqlinlukkhkj
tphukfnsqmfijpou	lhihoklulnrmroql
tphuknnrqmgijpou	ufrpgsiikfphrfhi
utjrfiksolnmpkoi	ngpnsklitmhkgqmh
utjrfqkrolompkoi	hkgsgfpsfrommrmj
lqukssguqstsolmq	kmjksrugqnlrjphl
lqukskgtqsusolmq	oskmljonoflothsf
tsqukorkktnmspms	otuukptjkuiismii
tsqukgrjktomspms	roiuhqmrskpifulk
oojuluukorliprro	mpftufilstggpkil
oojulmujormiprro	lfjonqjlljuggmks
hjqplfrfhmgqkroi	rohmilmkhkptfosi
hjqplnrghmfqkroi	olfstmrinispnumk
gujkitrkosoqithl	lrlliursfgsggjqt
gujkilrjosnqithl	mrfuliifgrurhfpr
irirgrpirmpukhhq	hrsupslmuiisgjgt
irirgjphrmqukhhq	hrmhlgrrlohmpllq
gjssqijortqjpmmp	rugrsufiqknsgrut
gjssqqjnrtpjpmmp	snhlptgsrhktrmlf
gsrpgpsllpjkfqnj	frjulomulgootuku
gsrpghsmlpkkfqnj	krorlnmjrjpmikqt
trttmumljqkrtiqn	qthgiktsrkpsqosq
trttmmmmjqjrtiqn	fsmpguorrsspmnkt
uonsuupqsmlnuugo	qjnqmllqmkqhlrqo
uonsumppsmmnuugo	glhpqhoohnkipjmg
ottothnumosrllkf	khiopiihojfgmgqo
ottotpntmorrllkf	guksrojhoufjtfqq
lggpqhkhroilrfik	tplnqghlktuhlhin
lggpqpkirohlrfik	nhmfqnjhhmisgsls
lmpmkhtkiotpnsun	gmkmuqjhtpfqfmnq
lmpmkptjioupnsun	sktktplfgimfrjrf
uuoklgnnsonutkhm	quollunigsqqlkff
uuoklonosooutkhm	otjrsipkqhnhijkj
gpplkfksinljslpr	jqiuplfsqqtkfosg
gpplknkrinmjslpr	pkjjjjhkknhomqpo
fuhnpmhkrprlngpl	krmoqpijikmrsohr
fuhnpuhjrpslngpl	osgmgntuipitfphs
iogqjhmthhriliqp	ftugrsqrkmmhhlkf
iogqjpmuhhsiliqp	upoqqnomloqrfoqo
rrlhjjsftpjfqngk	gppkrktrtjsqpini
rrlhjrsgtpkfqngk	ksqqpjiqifqjktgi
rrigksjhlloigknf	mrsplnjmiffrqirj
rrigkkjillnigknf	kfmpptsggqmjkioo
tpigmuunguhrrlof	hlqksktgflmlqqpo
tpigmmuoguirrlof	qgpktmgirijigiss
pfrngltsrolphohl	rssktlnrjlnlslfr
pfrngttrromphohl	hplssnfnuskrnuig
ttslhknlfsqnjtjq	rrhtsqufthttihrt
ttslhsnmfspnjtjq	shijtoqhjnupjgpl
jgpippgrfkjsoklk	mlqqiiijnmfkkskl
jgpiphgsfkksoklk	fspslinunsjhoqsq
lmqjuqmqoirfpgrp	hojllqnlruonkhlu
lmqjuimpoisfpgrp	sijtpnglugjqkrpl
qnslgjimunossqhg	oghfogopfrutgpgh
qnslgrilunnssqhg	kikshgokqpighuqn
isksjufuquhknsqs	rgrlphtfjofnpgsh
isksjmftquiknsqs	nkprtlfijlrsksou
qopsfjmulhkqmnin	pjrhurlmihpsqsig
qopsfrmtlhjqmnin	qjrshsjoroqrinmp
hkkgftljitmkfsfo	mokjlgloifffljoq
hkkgfllkitlkfsfo	ftmkkpmuohpnjqrh
lfnfpffughppfooo	ipupojlqigrtmisq
lfnfpnftghqpfooo	inkhukfkqgjpnftt
jtrkppmgjlklhlfi	mfhjtirslumhuqqr
jtrkphmfjljlhlfi	jhjiihofkjlsutfm
tsnqolrsljoroktk	opprsjiinisjhfkq
tsnqotrrljnroktk	igtkuqnnptjlrmnl
fkjqjsqnjopskhhs	fnrjmrlflmpqoomg
fkjqjkqojoqskhhs	kpujhkqskpkjsqul
smgqfqfnjrknsujj	orhmuojpqrkifjgm
smgqfifojrjnsujj	rrjjoohpjuosrojk
nshksiioqltkukrm	qrpkstoompkkjifq
nshksqinqlukukrm	imnghgqmoojogist
qskrsginitorjsrt	fqqfmphftuifgfqo
qskrsoioitnrjsrt	koshsfrhshklolhg
nkghsmtmfjpkqkkp	hlnrimmjhmmjtmut
nkghsutlfjqkqkkp	hukjmjopqnuuihjq
jsssjfsmqfmtsnjj	riukommogfnihilo
jsssjnslqfltsnjj	ohijhukpnflkhrti
qfunnltfosffsfpj	nurinliguutgmggf
qfunnttgosgfsfpj	qqtihmngmmtrptlq
jjtkioopuorpfgmj	llfmifpnkqhjhfft
jjtkigoquospfgmj	hrhjpflpurtfuukk
mjijootojmpmpfom	qktuqossoturqtts
mjijogtnjmqmpfom	tgglqknoingkpmrk
orjfmrtqpihlfltl	lriqhksoqpfrgoqi
orjfmjtppiilfltl	iomhurrmthiprnqt
uqfruhpkgoislnpj	mjosolrhgrlnjjrg
uqfruppjgohslnpj	hiktoigtpqqjqoti
fshmnsipgjtkpmrr	frofuifklsjrlsqp
fshmnkiqgjukpmrr	morpqnjssrnooffk
uoshttjunjhkfsot	sttosutrkjuuughl
uoshtljtnjikfsot	tfkogpsfisruhpll
mkqiluhkuttujmnh	pimmlummrflormlo
mkqilmhjutuujmnh	qiqgrhtrhjrgfqfk
rotlrnhqunghifkr	rpqsffnrigmnotnt
rotlrfhpunfhifkr	omroqgluroplopoh
qfuoufsmofspipli	nnlgttgguolqlflk
qfuounslofrpipli	rngqqmpmsjurttsm
gmhiuntlsfmmhokp	phtktlrgluojuqis
gmhiuftmsflmhokp	hfgjjtsmkolfqkqo
srirosgjlqofprfh	qkintknoiohplpmi
srirokgklqnfprfh	nipqlpqtroftojgq
nkktlqopsilkhnmk	pohglkuhmtutlqpf
nkktlioqsimkhnmk	tnhtsikgqisukmhp
pfhhorhmphrtpsom	ighiuommuqsngruk
pfhhojhlphstpsom	msjhpgppujopqmtt
jrpflpupqpjjnrpj	otktsjnrophjjngs
jrpflhuqqpkjnrpj	tlfsknotrkjtkkji
sfojfjghoiorgfgj	umqgptllmnoomjgn
sfojfrgioinrgfgj	tmuoiirnpqmupgri
mhhtgiktnlfhhqmi	hinjuosqotmpjhsj
mhhtgqkunlghhqmi	rroskmrrusfmmfhl
ntkshfljmlogijmr	nqoggitlqorkriih
ntkshnlkmlngijmr	uktjgjjqtqmurigk
shqsslgsirggqhjl	rmrlnqqrlnokfijm
shqsstgrirfgqhjl	roijpsssktmigssf
kmmqljmftqporppn	fulumrifmjnjnslf
kmmqlrmgtqqorppn	jfnnihsojnigknkk
stmkmuiohllltkuq	qjuminuiktkmrlop
stmkmminhlmltkuq	sqrurtiilgrfqrgl
rnfriphkrjplsjlk	kuqrljskhrmojtnr
rnfrihhjrjqlsjlk	iojpfupnkunrqrrt
qnkiiotlqojlmsik	tmoftiisftkilkmt
qnkiigtmqoklmsik	gipkkftslhmoilhn
qiuiskkpogouquph	shsjkonjrmjsmlon
qiuisskqognuquph	kinqgqponjljqott
mliusomiotufqlqt	rjoqtmlunoistqoq
mliusgmhottfqlqt	phnpnkgjkftunspf
jfihroupsqtokthu	gioslnrosfgotihh
jfihrguqsquokthu	quqjtkliifhklojq
kqqhjhmiissrfrgo	mmmjrtohhnokfhhq
kqqhjpmhisrrfrgo	pfiuoijstrommnni
fpllimoorngqggkk	lnmtlutkukkmjfpj
fplliuonrnfqggkk	hnuggosgkouousfg
lukqhqqthgohuofu	ihqglfgoqsuggnum
lukqhiquhgnhuofu	rpquihqjkiqfjnkk
grnnpospmstfnhnu	kpjmfjrilggttkno
grnnpgsqmsufnhnu	uhgtniqhkgfrrrsk
fpunokqlqnjnnurl	uhjikgqjfqkthnli
fpunosqmqnknnurl	srgrgtkqhnitufsi
guiigrnfiglthitf	tjqtuhljpmiuptsf
guiigjngigmthitf	isjmlsqnrjohogst
ttiiljiqromiofjq	kupuqfujfhrorrfn
ttiilriproliofjq	nhpnoofujhfnghtp
htktmpfffpltsfis	hliprgqsjgkgppgl
htktmhfgfpmtsfis	hkffpgohtinssuuh
lkopomufnkhoqfjt	kfifourmpsnosngm
lkopouugnkioqfjt	spfsfqtuprjrluoi
fumhqnfmjnlthtjm	mmknlofnfgkumsgi
fumhqffljnmthtjm	gfigpkntphtpoksq
glpphuutiqgjtofu	lrohqjlsmmtmtsru
glpphmuuiqfjtofu	iokoilsmkfnhimkh
qsljlkooijkktrpn	qlqkmsigintgfiio
qsljlsonijjktrpn	gphipirhkifjuslg
riutmjpuquioikku	pfthqjukqsiulplk
riutmrptquhoikku	gmjotfpngnmjptgh
fspurnuiomoouquk	rlksslnjtfgqsmpi
fspurfuhomnouquk	mrmntftgnnnrulip
quplhthmjjnhsksl	nnfuhmqtittkhmtg
quplhlhljjohsksl	piqopphmghjisqnr
tqljlgfrjnsrlluf	hhooojurtmhutlks
tqljlofsjnrrlluf	pmojihsktqgppmuq
hkpiohsqlgjjimpg	uqpuinpguojgmqkl
hkpiopsplgkjimpg	qgljnqqrslsiikrf
plqsjnpltfifhrll	mprrqinriqgtmpjf
plqsjfpmtfhfhrll	tpuqnuhnisjkhing
posruhhlmlqguolj	glrmhomulfljkuut
posruphmmlpguolj	tqthltofgmqhhsml
olknpignujfrhiis	qhslkqrmrsfoskkr
olknpqgoujgrhiis	itunokkrnqoofnri
fnkqrkkjlpnjfjkn	igqnpoftqfjrpnnp
fnkqrskklpojfjkn	imhpnnsulsolnuul
grhsmilrutklinqm	ijkpujngsmhnflsh
grhsmqlsutjlinqm	kjhjoogrfjjmofus
lmhfrphfqnrrhkts	tkqfjmmkuqgljigf
lmhfrhhgqnsrhkts	pghkpngjfqkhnfom
nqruifsuqrkqqksi	qfkjnmoiuugrmunf
nqruinstqrjqqksi	ijijfrhjhphmpous
tgigtiskfgttiqsj	qghnuhsuqhmtfrmj
tgigtqsjfgutiqsj	prpomupmpfggjiin
kotlfghnlnkkjhpq	unjfrjompukfgtko
kotlfoholnjkjhpq	rrpqnhlmsfhgrqss
ottrhklrsphotphs	nlpnjrurgmofftus
ottrhslsspiotphs	igqulnhnjrflgumg
qggtngmoptkqlkif	orlkkghsupioisms
qggtnomnptjqlkif	krpupmjnkjkoshjf
ootptiuumhfttljh	qtpjmtpgphqkiqgn
ootptqutmhgttljh	kiqpppjissjutnfp
rqlrtrglgsjpqotp	iomgooljtjihuqut
rqlrtjgmgskpqotp	ukklqpisgkrffgtk
suhljithinqjlpkn	qkhihtirugokgsim
suhljqtiinpjlpkn	jshiijokfksoruuf
mrhlrolihiprmgju	kmtfqkmtnhktutmg
mrhlrglhhiqrmgju	kstjiifgjhpjtuum
qtrisgmgmkfuifoj	ijuiuffrqpttqnpl
qtrisomfmkguifoj	ukonorrtughqqlnk
ppllnqlssupkphtk	rnquohuqqlguilsg
ppllnilrsuqkphtk	lnmfqfnlpigfgtmh
klpmtnptqgjgmoni	uninougrsuqkfsis
klpmtfpuqgkgmoni	rnjrjofpujjfuqsl
lguqlgthmphkotlr	ijumoojnhutquigo
lguqlotimpikotlr	unqmfhjssqfjpuhl
klggmrrsmpkllmkf	mhqrplrqrqpiiono
klggmjrrmpjllmkf	inlgsggisugmsmsm
hthumjrnmfpnsqjq	frirnttqtssninlg
hthumrromfqnsqjq	kgkfjojfplmiofok
pitjgomgmnpkhgkg	ujrhiqpflkmfnnfn
pitjggmfmnqkhgkg	jpjgkumginjmhjtg
pjqruunhhshujrqt	impiluohqromfsfr
pjqrumnihsiujrqt	rgiqtttunlpfokip
hhsgqtfkiltornqp	hgrnljjpmnrhkmrq
hhsgqlfjiluornqp	qrigsqffnmthkjff
hfkojllmpgfolrts	npgtsgqstinhillr
hfkojtllpggolrts	qtkukmmrlgjonpst
sjorofthiqjnojnm	hliojmglfpfiokrs
sjorontiiqknojnm	qikhlmilsfnsgoqk
ksinkoultuhqgqqr	mspnsfjmkjfnpglq
ksinkgumtuiqgqqr	pirsgtohplmtqunk
jsusftihjtuiggmq	pnogmntppgmiopsq
jsusfliijttiggmq	kkpnimqkrojnjhpi
snrslrquutpuhgji	fjpikjtfnkoskfni
snrsljqtutquhgji	imljospqhmtrrlmh
oisumjsfipojkkor	rsgqmphikogkqttn
oisumrsgipnjkkor	fsoojulhhksojrkg
iuuliggouoljhkqf	gouqokgqlrfutmlo
iuuliognuomjhkqf	uuknpklpqrqiltgg
guqitkfpgrmgstfj	iigshnissuouknhq
guqitsfqgrlgstfj	ffsrgtomhrtllkmj
mfqlntfhoshuftgj	kjkrmrpntrohfpof
mfqlnlfiosiuftgj	jhlkfqgutqiolksq
fhkjffsporsnotlq	lmnjmuhsqtoqthls
fhkjfnsqorrnotlq	mlojnuppquorgrgu
mqnnmsjlqsnorhpq	ffqrjotsoumipiru
mqnnmkjmqsoorhpq	fpusomsmluqtliij
lnkinilmtiogkugg	iqspmqhpjquoqoos
lnkinqlltingkugg	qqqsghlnmhihujlq
gonhflkioinqktus	ofrnsphrljhnkuim
gonhftkhoioqktus	gnrllroihrqgrnil
rtponrushgklhmmg	rqostlttijjphkqh
rtponjurhgjlhmmg	hqsfkgkqrjhrhjpu
tiqiugmuntujkumr	tpsrtujofspisufj
tiqiuomtnttjkumr	rlsjtutjsgqorpuq
ophptkqiofomkrqt	jpkfmqqskifpigpq
ophptsqhofnmkrqt	ljutglkgjohfshgn
mrgnrijirmguhhtg	jtotpkusjpjrhoqp
mrgnrqjhrmfuhhtg	tnpnujgsjhlkplup
tgigomhgrrrqfpqn	noirhmhohpshtikp
tgigouhfrrsqfpqn	ilkmmhhnliknlrpg
tqrsminftptnpfks	ltmhuoumjonnmkth
tqrsmqngtpunpfks	hsnlhjrqmjuhkkrn
ukjostjhgjkimiri	hptsfljhmgurshok
ukjosljigjjimiri	ktiuutopkujgqgog
tpqfnfsmponokiuo	ksmuolrktgmkooqi
tpqfnnslpoookiuo	gqqqomphirtpilop
ogrgtsujltpnrkmk	gfsljmnumpihmphs
ogrgtkukltqnrkmk	plnnpjjgkipfrmho
sruuoilkpnguiqpq	pmhhpissrhkgssrg
sruuoqljpnfuiqpq	pgtkptqpoikofonn
rmlrhoioglqptihg	hjokikhnfkftofmh
rmlrhginglpptihg	rpriplkkpkgptnns
sqogkgtpujgqhlsp	gmisoihkgqjnunjq
sqogkotqujfqhlsp	nijfumptiqrgntkj
ummkfpiqgumghsfu	gltiofoojhhpgnkj
ummkfhipgulghsfu	upsmoriluugppnql
llmtrsujtflrqtoq	gutmrkmfnrhoqojq
llmtrkuktfmrqtoq	gnromqrqjjnkpuim
mfnlhgihhifhghht	hofnqottflshnjki
mfnlhoiihighghht	nonifpnnqfllrmkg
uttmmjnglklsohtf	fpqplmpshosktunt
uttmmrnflkmsohtf	hhjkjmpuqqnqlnil
hooomjogilmfqrmh	ojqjjuiquujtmmkl
hooomrofillfqrmh	tjsqfmkmlhgqmlqm
ugpqmhfpiqqiikqg	fhfjgjfrqgsfngnt
ugpqmpfqiqpiikqg	kohmtuisspthquqm
utfgoqhlpuhfqsum	imjhlsqrorqjprnk
utfgoihmpuifqsum	tljqjrhhssfrjhrt
ikflsskmhljnhhpi	fisljfusifmfjjfj
ikflskklhlknhhpi	oftpskppokkrnqri
jsrkqklknlunknpj	ngmkuogtsjkmqrms
jsrkqsljnltnknpj	tiljqgpflfmumrhg
ominttspntrgjsot	hinhgjuqqqnrnmjq
omintlsqntsgjsot	pgjhqnofjfqqimri
urrjrkfugmjoofuo	rnroujrkpghrnhin
urrjrsftgmkoofuo	smllofhinftsufum
uploonrppikpjqqq	kjfktsqsloglkggn
uploofrqpijpjqqq	hnorikuuhitgtnlm
omqmmnrqjjphtrmo	kklfmqhkimjtthoo
omqmmfrpjjqhtrmo	shhslpfnjuhuptlh
iutqhjpokhnqpqft	pluntinlntpomuhs
iutqhrpnkhoqpqft	rfusqushnionjptm
shsrppgjpffigtfk	prrgtsnnmfljgulh
shsrphgkpfgigtfk	imunhirnqrrrojsr
poffgmhjkopikjqf	oihfhftigmfqflfo
poffguhkkoqikjqf	jlguosuphhfphkru
npupftstjmtkrsnh	gpigurkquiuthmqj
npupflsujmukrsnh	rfmqpfiukntugjof
gupujjjufihqopgn	qklkljngjsmpssui
gupujrjtfiiqopgn	jgtpllqritslgguj
iliqggiqngrfmhlt	pqolruitiqrouujl
iliqgoipngsfmhlt	pmfifssjqsugqtfl
lojksqiliuuqtnrm	kkifknsmluoriqlr
lojksiimiutqtnrm	oikshgmnjjjfmshj
upqrqmjhrssqrlmt	fggsjosigumuqimo
upqrqujirsrqrlmt	pgonrnrqhsjhsiof
mruhpiujofsigutt	ljurimnlojhiiifi
mruhpqukofrigutt	ffohhupllkuugkji
nitfjqotfiuikrus	psmsorinifgiosns
nitfjioufitikrus	hhlgruplloolgqio
litijsqmmhtishhp	rkmlusttgoioqmis
litijkqlmhuishhp	jlfsoirfnsqpmnlf
pmrnjnjqsmlmfptt	ktljkhoqkusmkgnj
pmrnjfjpsmmmfptt	rgunfhshsksisqqk
smgffjprmphfhpqi	pjujnfomistuqgrj
smgffrpsmpifhpqi	rlinugfisfuggujf
qqmglonllominlki	jnmukkpnqttijtgh
qqmglgnmlolinlki	lftmushlhfhifkmh
lhuuklhqjmltokhh	ipokjmpkorktgpgt
lhuukthpjmmtokhh	hutoklgpqrgjjjoi
onhfrpqskgglhlpr	stqfqkrioukpmsos
onhfrhqrkgflhlpr	nptkoopqkifknsqo
oqlkfqlmlhlfmoum	hknofikjjinhfnsm
oqlkfilllhmfmoum	fgukrortjfmojfku
lplkurjqprnuhlut	smsrimfssjhtglkn
lplkujjpprouhlut	umkkusffsmimrhiu
frflmfpirgmoiito	orijtmlppksqjsmh
frflmnphrgloiito	hmngsnuogupihgsq
kqirmqihpqipujut	utrkmhpoknmnrnkn
kqirmiiipqhpujut	glrjootofqkkhnik
fqkpmlmruminimur	rhtoooluhupmrfof
fqkpmtmsumhnimur	nqmlnlhrroimslnj
plupfiffttrsikss	ogkpulhrgptuhiun
plupfqfgttssikss	sggpgplniosgjglr
npupiskkuqlsginh	lokmkpkjuuniqsrf
npupikkjuqmsginh	gmsqrllfltnlsqrn
fgjigjlsnommgoul	ssjkogjfittinhik
fgjigrlrnolmgoul	srpiqfuiqhqhpuqo
jhinijmgthghitji	gllijioltglmujnl
jhinirmfthfhitji	qutrforsiqprsnqo
ogghtgotnsjfplpg	fqlgmtpsfpusohtf
ogghtoounskfplpg	kjkpuuptjqjrktkl
sikthmmtjojkukhn	opmrufliogpfmqpj
sikthumujokkukhn	kqfutokgklifrmus
httpghgmhrtofsth	usuuhokluqimorhn
httpgpglhruofsth	psonjfqrmonpgotk
nmrhhofolujsmsmp	uhgfsumrnhmlgrgq
nmrhhgfnluksmsmp	hnoqqtnmugugtrqu
oujlpfspihkuiljl	kuggokqpmmulojmo
oujlpnsqihjuiljl	juuhojnjigjgfuqf
ijgfttsqjflsfhrf	prgjqtkgjjiofskn
ijgftlspjfmsfhrf	sqgokllrjnomrsrf
irggtrflsunofhrj	orrusqjugkrorquu
irggtjfmsuoofhrj	lpofgfinjmkhmplt
iqgqiijojfkpqmjt	hoqhngfhshfnuoqo
iqgqiqjnjfjpqmjt	upqjtnrjlpfuopot
npnnprotjpmpmunh	hqlnknlfjjlsjpgp
npnnpjoujplpmunh	fsnsjrktmqrhmpqh
npjgtffumiilksmh	rfukrqnmkpmmiufl
npjgtnftmihlksmh	qsppjkrohuhnkhut
olmttrkkitinsorr	ffkshqsrqrkqihif
olmttjkjithnsorr	rjuijthijtuorrjj
qtgfhgisnqhjtsrm	tuqhiuotkjfifhpt
qtgfhoirnqijtsrm	hqsiphqiloquuomk
oitkmlsoottmpltm	frpotrtmktfiqmtg
oitkmtsnotumpltm	njjqkkhttfnniojm
hjltstuskfqjfnls	sifnlqqqppmojfqi
hjltslurkfpjfnls	sjpummtmsojurros
hsrsmhshgrglhsqq	tfpoolmmftkirhkn
hsrsmpsigrflhsqq	jkrfrfirtjmmutnk
mpohpiqpgkpgnfjq	frnhrgpiknqpthsu
mpohpqqqgkqgnfjq	pjnttjjhllrrnhhn
uiolpokfkjifkgph	shqsjipsqisjgmot
uiolpgkgkjhfkgph	nnnkrsomrmnqfgjg
ukogrsrorjrqluth	pprksuunffkgnnot
ukogrkrnrjsqluth	qksjsilujtrfskmr
jhifkpmlnhnjgmnl	mhhofhrtgjmptsls
jhifkhmmnhojgmnl	lnsnshunqglqmsft
qfskmqjonnfuhmqr	kmmhtriupmmkllml
qfskmijnnnguhmqr	kirsohtgthhpsjpk
ijkpjfmhugkoorio	oshkhmlpqjqggush
ijkpjnmiugjoorio	ftnhklgghhhfslql
pogimhruqgrpjruu	gjkngonujpqooflu
pogimprtqgspjruu	gurnponpmkmromqu
fqppmfuhqpksltlo	tjiftpnfltrtoomp
fqppmnuiqpjsltlo	mfgrrkmtsnliqmif
qiirnhmotjgkspju	ntpohtnqgjstsjuu
qiirnpmntjfkspju	fnpqtnkkoriquiqk
fgmprknouusmmnuh	quutmhfotjkqhjqi
fgmprsnnuurmmnuh	hogmkltqusmfjsfr
hmspgkjsqrjipoui	tsnjumthtgsgmqhj
hmspgsjrqrkipoui	lfrrjurkglqrhnun
jffpqnhflupimtfs	rhqonnsrsmpsklst
jffpqfhgluqimtfs	llmrgtunlnftptfq
polgupmgnuppftjg	jumulgmrrimuoniu
polguhmfnuqpftjg	rguriquhntsqsrki
urnmrhhpigmlrskq	mpoqhsksmnjgqsum
urnmrphqigllrskq	gtgisnmikqkljljk
lhfsjhokniqrsitp	ipjfmfhilmjqmptr
lhfsjpojniprsitp	fkfjjnthtlhjnmhr
tjrjiuhuptrlkshg	jppsohlmlskuqkri
tjrjimhtptslkshg	gsfkrgfhpmiufjhn
hgjlhornistnkuln	trjuqnmilljuunpp
hgjlhgroisunkuln	urqiptousffinigt
ohokgssmqgrssjkk	hgmrgsmlnqmmklqq
ohokgkslqgsssjkk	pstjlqursqpmpglg
lmmpjfoonhjrmrqk	ogriqnuuuokpigol
lmmpjnonnhkrmrqk	unlfugsotptipuoo
lnqrkfhnqooforlg	ilqipnulonmukurj
lnqrknhoqonforlg	mtpmgkosnmssmoii
lptsltkqhfguhpum	stukgujmmopgmljg
lptsllkphffuhpum	hmuhllqklqkmoqrf
lhpmkffnkklggllf	ponqohmqlliohqpo
lhpmknfokkmggllf	jlhgrftmmlpqkgfj
mftouhqmmujnfiqn	jsgfqmrlssksrlkh
mftoupqlmuknfiqn	tlqskpmrksjgpguu
rlhpgllifpfguqls	rhlrtkpjnhsjmjss
rlhpgtlhfpgguqls	ppkouisminkhirkg
rknqomrumrhkftrl	onojlqnugpjllppn
rknqourtmrikftrl	ntpjhljouotsrtfi
hsgngghrkpritipf	hgrfnsmrhghnpsff
hsgngohskpsitipf	ulkmqfqmlsskihsj
irkhoqihgfllsroo	kkhfhjqjjrlfmmok
irkhoiiigfmlsroo	lkisqhjifsfjjnpg
gikuqnjujntsqgnj	pklgnmlphjsjurtr
gikuqfjtjnusqgnj	uptsrsqipsppfmug
ihpqhgiorthgllfr	ppshktkthkjoohiq
ihpqhoinrtigllfr	sgulktfqklhninlq
gorhrfglpmuqotnu	gmhnrhthtmskitgh
gorhrngmpmtqotnu	hilgqfiinoqiqrkr
rllonfkmrmhfmrfr	hrkfjpjprktjpnuo
rllonnklrmifmrfr	roslplmsmghpiuus
kugqkfghspursqql	pqokrltgfujgpqfs
kugqkngisptrsqql	sipjtnphtgstfkrs
jiighnssptkpgjhl	mgqftoinorkmjmgj
jiighfsrptjpgjhl	kpqltlngorjjrjfo
fjolhuifrrqishgg	kimikijnfuntisiq
fjolhmigrrpishgg	murgofrustsonjhu
hnrpippkrunmmlut	qgorpnlotmmghqhg
hnrpihpjruommlut	nuthhhmhmirtujsp
kgploiiirukljrgt	plmphiuppttkgmhq
kgploqihrujljrgt	mpjspqrlptgjjott
gnghspsjfujohsrf	orlmoolgosiponqf
gnghshskfukohsrf	nrqlkiiqtqlqlqhi
lplrinhfiirjnsgf	pljgttrgsgqsptnt
lplrifhgiisjnsgf	mufgohjhumqgnnti
qkipnllullrllmon	jiqokfoloptmuorf
qkipntltllsllmon	rshljpnjftnungtl
irftugoioqissolg	ifpffoshnoflkjrq
irftuoohoqhssolg	kmjloigtmnilsipt
kpnmtmgopioulqug	okjsjitliqkjrqrr
kpnmtugnpinulqug	fstlqknlflmolkuq
guthnhfffuongtlp	njlimjsijgltginp
guthnpfgfunngtlp	luinoiphfhjutglq
knnottmquhsthios	stfutkqpqguorrtr
knnotlmpuhrthios	okrtuophpgnslhql
toltrjnulniqluom	hqkprtfpsqqgtmtm
toltrrntlnhqluom	gojqjogmjrgpkuhi
fhgmfsirtgtsjiuo	slnlpukmhopnqopf
fhgmfkistgusjiuo	qrnpsijkrlqornpq
ssikiutmruqnllpl	rufsmpoqosnnljhj
ssikimtlrupnllpl	upngonljiojjksht
frftgjoqfhjnrkhk	nkutjiljulptthsn
frftgropfhknrkhk	oprntfjlfkqnjlif
puupmipjltqlptsg	flrsttqqthfnnsfm
puupmqpkltplptsg	nlhjsllqlhsjhlum
knjlmrjjgusthomh	pkmjfjogrphohgms
knjlmjjkgurthomh	iguiigiqjhtpkunq
unofqmmpjpqplhmk	opiqpjfgnupuijhm
unofqumqjppplhmk	ffhjtllgmnrkfuiq
ipqsqthrplqplsjs	lfmpunihgifrhugn
ipqsqlhsplpplsjs	koffshomrmpklqpr
fuhrnmrqoffgskhi	tphmhofjtlksrgkp
fuhrnurpofggskhi	ifkoonsojirpnsom
orlnjrutonnsjoro	hurmlktgiolsrqmt
orlnjjuuonosjoro	homkmiinqssrmtft
orlirtgnojjmmjjm	uohqijlflorolrgr
orlirlgoojkmmjjm	ssshlnnhohmjqnio
ujiuphnigoggnrhp	kqujormtrfriiqgk
ujiuppnhgofgnrhp	qnsgjtmuilmnuulq
qhqiorkfmflgkfuq	lhlhsstugjfhmogq
qhqiojkgmfmgkfuq	soqflgthjrohrkgi
kkjtfmtjlmqnikrh	hpinlsnpqssitqsf
kkjtfutklmpnikrh	uhmmjqlmkokjhquq
mlniprgluulkpipt	rhtjnlipjostgtkt
mlnipjgmuumkpipt	klprkhkfqmktfmpq
pssgujgmujriuifl	qriposfhtuphtlsi
pssgurglujsiuifl	uhrlmmfjpnlpmust
mgsffqttsqmiqkqi	hnquourqomgmqqlg
mgsffitusqliqkqi	mjsjgfosnjsmqoqp
numtsoqnufsgtpqk	kkgfnppkrprgufgg
numtsgqoufrgtpqk	qjmjpqnfroltrlht
rqpuikligoohfiom	inghqmnhprouomji
rqpuislhgonhfiom	unjroukrsjhquhqm
ktuouimjfhspnihq	rfgogorjsjggfrot
ktuouqmkfhrpnihq	qkmuffkhotsfqriu
hnfogigplkihlkru	jkorgtkioujnimpu
hnfogqgqlkhhlkru	tfrplmplfungglti
nlkimgfrhsmkhkpn	sgutsjngihourihj
nlkimofshslkhkpn	hlkmtrrttfnmiqhg
pikfiolphusmqjfg	kjiquktumtnhtmln
pikfiglqhurmqjfg	rltsomrnhrrmlsuq
qonpjtmkqqftqshq	sokrkjljgiiihotm
qonpjlmjqqgtqshq	lqurrlmnhuhoifnm
iirkgkooklupqujt	gsnjnsssjnljjnpl
iirkgsonkltpqujt	snphnhlffljqprmm
nhffrptskftmmfnn	imqshmmggijhuthp
nhffrhtrkfummfnn	krqlogfmmlnirlqu
iihkknhqtrkshtlu	kinnrpllppqlgisf
iihkkfhptrjshtlu	psqmtmuhpfiqipoh
tjlrkpqmltmugmui	iqrkqmifqipighrn
tjlrkhqlltlugmui	fhrosnngpuqplrpp
thorsninhkfoioqo	kngglqjknuitsssi
thorsfiohkgoioqo	smrkpmgtghjsmsqi
utqousmkkfjjpoji	nsuhlqmljtmthirk
utqoukmjkfkjpoji	qnnoroklkhgoifqo
sptsngiupkhutlgu	umihplnfpunlrqqt
sptsnoitpkiutlgu	kqhiggrsklfulqln
ogmftrlsjliiskmn	jqlppngpiupmoqtk
ogmftjlrjlhiskmn	ukntfmpnonjqsmpf
hjrittqlhhfhjgnr	pmssktlkpkuuuokt
hjritlqmhhghjgnr	npqhmnngrotfijnj
pflismnjsunjnmlk	oqjsmqtqsnltplip
pflisunksuojnmlk	uslfhkqfkpgstsuh
mfiqqukgskruoqjm	pilohjfrmumtihlt
mfiqqmkfsksuoqjm	ogsislmtgtfttkli
ogttltkimohhpgur	kugopfstjhtsqfoh
ogttllkhmoihpgur	pqikitnrhshskmoj
tfpgoqrlourisuno	tpurtfmjhloqnkmh
tfpgoirmousisuno	kuhlnromjnuslgrh
fgkgfogpmkfrsfuj	qnmunmmroppiprqk
fgkgfggqmkgrsfuj	tunotqqfkllmopnf
mgphipmfprtlhnit	skoqtlkrospqmjnm
mgphihmgprulhnit	tguhsljsnkqjghor
smiklupkqflhjpqt	mfpjlfrrssmililr
smiklmpjqfmhjpqt	fnqrtphmpmfqpolf
rmoilrkgouiojmfg	jiihkkpjkhfqojfp
rmoiljkfouhojmfg	tluqnqsslkurhmij
kgmipiutjnuhkpng	pqrgllsjjnooffis
kgmipquujnthkpng	ptopilnnmrnofrfr
toijqumotlfsnnlm	jqkjnhofnshnorpi
toijqmmntlgsnnlm	ssfnpnfkqoukhggl
ptqkjhofkumjlntm	fijtmplqphghlqpn
ptqkjpogkuljlntm	uhttohjgsgkrtogf
ufirhhkfjnmnjooq	mtoohmkgkrkqujig
ufirhpkgjnlnjooq	tirgkrmgsglgtqhm
qpulrpntsfjsluuu	qgqiqrmnohguqirk
qpulrhnusfksluuu	ufikholtttqhjlkh
kjhfofqtqqtmuoih	jjnmthjfjsutflkq
kjhfonquqqumuoih	stnuhmsqligiqqgg
jipnkoqohjtsmlif	lhtfqthtrpionkgh
jipnkgqnhjusmlif	hlsillrhfnsflkrh
ftnrfgjfgojroluj	jpsnpsfnmrurhljn
ftnrfojggokroluj	snupuoihhpqtkngm
ofirlrflikkrorlu	righmgmqmhrnjumn
ofirljfmikjrorlu	gjotplfhmrsjosig
knmqrusklhjtuiqk	usumqslnqofkfosi
knmqrmsjlhktuiqk	hosllrhlrmislngj
krgutnipnpqifonh	nnomsgnnmmttqtpp
krgutfiqnppifonh	trmhupfouhuiiqmf
ttnnunjulogjkphs	kqhuolijpnhuqtfh
ttnnufjtlofjkphs	nkohunuiffqpujlq
rrifusmthhnlnmrl	korsomqqtkrmrror
rrifukmuhholnmrl	sjijssjiftjohkpu
qqgkigrjporgnrpn	itgstoqgifhjrogo
qqgkiorkposgnrpn	kprnrkjojpfiqtor
tougsiogotkjnkfo	gskltiqppingurqn
tougsqofotjjnkfo	hsqmnfllpkpkiimq
iqqjmtgruihrojho	qjnuigpjnonphnqg
iqqjmlgsuiirojho	qrhouifofrhslron
rhtinfqkkfjhjrsr	roogsmsukrsupull
rhtinnqjkfkhjrsr	iliuhukuutlqhpqm
tgrggntnjnohimoq	qjofglrkqupjutfh
tgrggftojnnhimoq	fqrrqjjtjsfktkhs
gpjlhnofkttppojk	lpjopifklkofutjk
gpjlhfogktuppojk	mmlpulgohukmljiu
lnpiifqfltrgunmq	pfjnogpstjlhjoop
lnpiinqgltsgunmq	shorhsumqsukqplj
fukmhhngrrifnqlf	tliohkfgnnqtfusj
fukmhpnfrrhfnqlf	ilqsgnmfpnjmfigg
lnkntjrquigmhqlg	mioqjgkqorprsjor
lnkntrrpuifmhqlg	tghftqlnoouoisir
tikquknhtjtmrqln	plosolutugspjntj
tikqusnitjumrqln	fnotpmmogrgtgjhk
sgntffrliqgtglpl	tqfhppkfsnquofnh
sgntfnrmiqftglpl	grntrkqsjiqgumil
jtkuhqfjtoqiirff	sqnhrpijqtpfuqpn
jtkuhifktopiirff	gusstkpjstrgtgnp
qjlfsngphslijonf	jtnohpjsfrqomsno
qjlfsfgqhsmijonf	soojtsomloqmpljg
ugqmnfhsruphltgi	hrpfqsurfnshrhhm
ugqmnnhrruqhltgi	fjfgijkgtjntkmlt
juinpulskfgkspql	qpggtsqsfuotshkf
juinpmlrkffkspql	gmmnjhtufmrjuhjg
rogphnluugujktpq	kntrlkljorgnrtmi
rogphfltugtjktpq	mthirnlpiinsgfio
unoljqstkuqjjioo	krrgsqfitljumqpf
unoljisukupjjioo	fqliomusignnipjr
gghuontrfhsqpfkf	gnlgoijohokskltu
gghuoftsfhrqpfkf	ngtumirhishljshr
pjnjrnggkjkhhptf	qggrnnjmsgnsrhrm
pjnjrfgfkjjhhptf	rhifkpqsigsslrif
jmpokrnjfhtoorjh	pllkkhhiqllnjhmk
jmpokjnkfhuoorjh	tupohfjlmjhltksk
itslgntufhihrphm	gtgmjigigprlmhro
itslgfttfhhhrphm	tpihutjhnokqlgnu
mooijoflriuufhnm	ujosnuqujgpollqu
mooijgfmritufhnm	gmrkpgtmrfhspimp
ssnttumnpnjggfgj	kukgugqqnlpuojlr
ssnttmmopnkggfgj	hiigiopjhojijihu
nrlskojnnfgtfolj	nppmflsoqnopghqj
nrlskgjonfftfolj	lrglumprliprliul
muhiittmttrshgug	tpntuukqukfgsjli
muhiiltlttsshgug	oqouqsihrhitonnq
sjoiuqnjgtffsjpp	uqpfilpgtjjillru
sjoiuinkgtgfsjpp	hkfsmprphkslflqn
liqgpsfpgskhsirr	sjkjqpooljrlqstu
liqgpkfqgsjhsirr	gsljjtsrlhhkhtqk
lhskhkgmktnhsgir	irulimkqlutjriin
lhskhsglktohsgir	rkjuomkrtupjjqhq
olptqgrgujmmjmgt	ropstgmolqohgqfj
olptqorfujlmjmgt	hgguomgsjirmsnrl
tiqpuorslntgfkqo	rnltgrgsqorjnpsh
tiqpugrrlnugfkqo	gfnoknnoojuuigrt
ukmjkprqgmrjnmri	pgioffhqirgukigj
ukmjkhrpgmsjnmri	tpmnrgfmoipqurrf
rkphtmhiglfmhplj	prkuruusokpotpjt
rkphtuhhglgmhplj	lstumfojfkkjipsq
nuhrfunlofqjijqi	kpltnjhjmijjkipr
nuhrfmnmofpjijqi	mloilqrounlinggm
joqfijnhoulkijlj	nshufiqhfquriogf
joqfirnioumkijlj	ngsspkqigojpglls
gsjkkjgtmrsjiton	stiqroqloqskiuqn
gsjkkrgumrrjiton	tkgqsoirprmrjjog
mqqkrrtothhghrso	ukqiltfsntpossrt
mqqkrjtnthighrso	hkqgsmklltnklioj
iumhnopfitmtrfup	omukfsqjiktiukpt
iumhngpgitltrfup	rfpmkkpiisijiogs
ltqsmutjltulpklp	mqtmluqmnuikhgtr
ltqsmmtklttlpklp	jgtgljqjhfifilmo
shgfhjqhtplnutph	hsilnlggnuoqtkrn
shgfhrqitpmnutph	nigiuskghgnhulos
ffruomgnjlnoihut	ffrujhotrougorrm
ffruougojlooihut	rigqiormrjgqkkgl
mkhigtmujghingig	lhgthugkfofpupns
mkhiglmtjgiingig	ongrgisqifjfrrkr
njurohshlmkphkjg	ummtjkrtugmmgort
njuropsilmjphkjg	liqttusuusjujkfn
skqgmfjlgppnqlfo	shpimfsgifkigikg
skqgmnjmgpqnqlfo	mrgugsirqmfgkrkq
kgisnhikkkfkshkn	qoffikmlnmlomilo
kgisnpijkkgkshkn	lrhgminfjqkpghum
rfnjfntrfrrmilpl	hntftjjtrmtrhijl
rfnjfftsfrsmilpl	lmtkmhrjsquojgft
onlpuhfsptonqmqn	fiqrloojulfsioup
onlpupfrptnnqmqn	skrfuplqoqtfgpfp
hrorqhklihsigsii	igorussitiirkprs
hrorqpkmihrigsii	tsuttmhukpojkfnt
pkfpumgmggohhohg	ktroqmilqtittmrf
pkfpuuglggnhhohg	jlijsopusjjfjonn
igrtjgumutnruhsq	okjmsghkgkrogkii
igrtjoulutoruhsq	fgiqqohkrqhjsfkp
onhqugrihinqosik	poitrjosuukkhqlf
onhquorhhioqosik	shrtjlqfpmrkioom
nrqplfnitosumpps	ffpnfjhjgtolfuog
nrqplnnhtorumpps	ffqjmrkkttlpmliq
lhmijnrkuuqrnohg	pkniofllttrtntgs
lhmijfrjuuprnohg	tssknnjittmqkipf
phjtiqrhuuoiilfr	kkskpopjpfolitff
phjtiiriuuniilfr	pptnhkklpmmgrsot
ljihlpokksqgupkq	urgiirjqjlsmgmrh
ljihlhojkspgupkq	lknflkrhuqgqgpil
pmmhhosrjslnhluk	shmquhsmhghhqusn
pmmhhgssjsmnhluk	fkioklrlksmqtisp
tmpnkurpjotorgfg	fqmqnktpmofhfirk
tmpnkmrqjouorgfg	ogooqjmmqfmofrpk
ijpiqfpsntpgpsgk	goolhmsfiqffjmpj
ijpiqnprntqgpsgk	tppgplrknspuskrk
unfrhsokqssfqmin	onjfhmnnhrnooogp
unfrhkojqsrfqmin	mjuqflrflkiflsrt
okjkpunmmrujipng	munqgujqsipshllj
okjkpmnlmrtjipng	gmmrofluspgookoq
psqtkfmqumfqrhjt	qisiitnunjjfrmjl
psqtknmpumgqrhjt	omqngltfkkmhsnun
itjflkulimsmngsl	higlsrgjggqsshqq
itjflsumimrmngsl	ilfnfuqhsghqjpqj
sgmonlspkskphoqq	irthgpujuqmrukkf
sgmontsqksjphoqq	jmmhsnumrsjgjnrs
ksqqkrirklhqorgr	hsnqsmpqhjskmsip
ksqqkjiskliqorgr	pjihmmoqfgjjusfp
ojjqotqoskmpmhhs	spklrqhjrgjgqiul
ojjqolqnsklpmhhs	snjtptirjiqnitqn
ifiilpimisppphjg	jrknpqphqmnofsqo
ifiilhilisqpphjg	hnlhpmirgfhpkqmh
migppmkqqjsufiog	fujmunuhliokqsjs
migppukpqjrufiog	plsjmnkgmqkgjfop
mnspsfkgpimltpfh	prlrfohosnijftfu
mnspsnkfpilltpfh	kukrhlrhnshjhouh
hmtshrtnqksligit	nqoggujfmqrtqiif
hmtshjtoqkrligit	frusjttnnlgmqpup
ooospnskonrkqmmn	tqmqgmuuhhhfhuqu
ooospfsjonskqmmn	spsoglrgoqltntrp
iuhrsosfptiqqlmu	imufmpnlngpliimk
iuhrsgsgpthqqlmu	sfrtnkmngrlgrrsi
krjrttoolqtrtkrh	gnjrmgfpogqmpsij
krjrtlonlqurtkrh	glqijqqrjsotqquh
tnggrofoirlkhnhu	immrkjkffuojktim
tnggrgfnirmkhnhu	gpikoputfggpmrst
kilughtrfqplljsi	ftjtfnssnsqsskmt
kilugptsfqqlljsi	hkijijmulhphpfrl
uquptlgtnffgstml	nfgrlufphtlhjism
uqupttgunfggstml	fngoisgqruougust
mufugjlhpmrrhniq	uriigiftrimftpfm
mufugrlipmsrhniq	klsjhnfpunhsmsth
hpfhqjttprrnpsmp	mhflfqghpnumursm
hpfhqrtuprsnpsmp	lrgosmhmqisifliu
onnskmgntrugthoi	htqktpggrrhmhogf
onnskugotrtgthoi	sonstsushghqmrgq
forgkulhlgkjsljk	ritrltssjrtgkqjh
forgkmlilgjjsljk	mnhrofrorqtggqrp
ifugrsgqhtqrgqfh	pguulrlptumilrrs
ifugrkgphtprgqfh	ljlfhpgspsglfoog
pfssgogsfnrsjkrg	ngqkrhtofntgrktn
pfssgggrfnssjkrg	gljiifknruprmopm
lqfhhgghgfntsffs	jkmrtqkihrgkjhsp
lqfhhogigfotsffs	tqpnnsmnkkgupkhs
khnttjnfrsupuqpk	hsfnsjnjqhulnjpl
khnttrngrstpuqpk	luuojfsfioijopms
trhmokljfklkkgjm	ltlmojgnofsmplnk
trhmoslkfkmkkgjm	supnsufpqrltrmuh
fkslqmjnsjkrjgml	gioltoipruqjotqs
fkslqujosjjrjgml	fpmffnfrmmsksfmk
pkgpgqoqpltmuuoj	fkqgmnhuqlkrgfml
pkgpgiopplumuuoj	ouhilnnhkpnirfgo
lppkhqnkfgntpilq	rsjtomhgqmmllsnq
lppkhinjfgotpilq	nffstpmokpqsnptp
pkttmkqfmnpskmou	shsqsojhjpgjjlpj
pkttmsqgmnqskmou	irsmsrukllpoqigi
qisihntogurlpisl	sghukuqurprkqijh
qisihftnguslpisl	tsugrfrghtjhmkqk
uttikpktjtjifksu	khhoqphmunfkpuru
uttikhkujtkifksu	pmnumkrhfpfmogjg
thmsnsiupqjmmljr	lihimjiongsglmtu
thmsnkitpqkmmljr	fjpltmfsjtlsghgk
lrsjtnkmronhqjfu	gtrikpggljnkutqr
lrsjtfklroohqjfu	jlrqqjfkphsnprgs
qpfhqippruplulfu	hmnpgogmjojriojn
qpfhqqpqruqlulfu	fofnrosistsoiqrq
ornuhsgfnjlgootk	pttgqimohkhshlig
ornuhkggnjmgootk	pimuiorpkqppphhq
prnitgruoriknmuq	smhltkpfgmftsjng
prnitortorhknmuq	gjlusskotgpiktnn
fukngftugggnsqos	pisnmooolumuhkli
fukngnttggfnsqos	muntrrfnmqfiiorf
tnsqhnluiisuhtso	ouuokqmllujingpi
tnsqhfltiiruhtso	kloktrngkuqkqqhm
nlmfuriojqofnmlu	nohokliigjsirqpp
nlmfujinjqnfnmlu	jjpftqinssnrptgi
koutprsjiqgrpqlk	jqmqoomrihrnrijt
koutpjskiqfrpqlk	tfgqlfhilghgrhur
rkumqmmslqmuornm	hupognqujlgitgoh
rkumqumrlqluornm	urtiikqnpmrmmnhg
utirghigsshfompi	nklsfkupigsqmfun
utirgpifssifompi	hnjrlggpnhpttmlq
qjhohljfmtmhkhog	nrquiggnqriiirrj
qjhohtjgmtlhkhog	krnprliknrnqjqns
ggjgpkulohsmfjuu	piopnpltsosqfqum
ggjgpsumohrmfjuu	mtjosgmrggjflpll
josulfqkthhgisjh	rkshuiiqtukuupto
josulnqjthigisjh	sisgllnnijijmlko
opgikktsqlqiphhj	pjmungghonqfhikk
opgikstrqlpiphhj	ngptmjhrjmiqkmku
ufqupfumfffkghrg	nrpmqjguokhrimin
ufqupnulffgkghrg	kskitnhqtmqsnnot
snujsspsthgufqrs	snfhglnfolofogff
snujskprthfufqrs	iqhfssplqjjqpojk
igmuthuqinirrgsr	homiqifflfjqgslf
igmutpupinhrrgsr	uihskhspqhhpmqgs
ukmuuumlqhqgsrqr	tjtiuqhurglnmnst
ukmuummmqhpgsrqr	pshlqghqguupghnu
mrjmikgrpthqufut	hkkinlmipluslirq
mrjmisgsptiqufut	jguruqnoomuslirm
fukgqtugnfpsgris	snnjhogtmfnqrrrj
fukgqlufnfqsgris	mjthmoholiotssqp
njjooqkortqoimpg	nmhjnmgfmumhjjmm
njjooiknrtpoimpg	istftqjhfijptutf
jjkogmsinuljprok	hkgiflhghpqrkikg
jjkogushnumjprok	lrfuiojsqipkjfhl
qikutfptpkfurpmp	klshpsomsnnuflmq
qikutnpupkgurpmp	hgsrtimprfpugpon
gghrtiippsuknonl	qhqqjrtmnnhuplis
gghrtqiqpstknonl	gflrhtfighgonhkt
sjkhhmmttrsnlrjn	hnsmgqjitrtpouhr
sjkhhumutrrnlrjn	hssthkjqrtfqismm
mfpplrosfooflqhp	rrrfotjrlrjimsou
mfppljorfonflqhp	hnnmqrohftsrkfrj
mnrlnoukiusoosrr	rlofoqjkthrpsmqr
mnrlngujiuroosrr	ggkfttkoinugogqi
hlrnnfpfgqusurng	mfqthmnpmnrftnff
hlrnnnpggqtsurng	qhoprpqjouspmrqr
fstpqgkfusousius	hgttjmogmusiutfl
fstpqokgusnusius	mnlfsmggsnmsmugj
fmsmniphulkgtuno	rlrmjoogojgunnpo
fmsmnqpiuljgtuno	niqptrrtrsusqrpo
glhimonpuifmonfu	khtrkjhipitlhfhk
glhimgnquigmonfu	shtqnikgftoirimt
nniuqsilguotklfj	tqigorttggmokusk
nniuqkimguntklfj	rfninijftljtrusr
rmliprsgflpuskps	rfhopjtiouqimlro
rmlipjsfflquskps	tpgnjrothghqputt
tprfllnfglkpgoqq	trkonrrjgppfqkuk
tprfltnggljpgoqq	mqltkshmsumoofqp
nkkqmsnoqqjrhmll	gusoosnhhffijjfj
nkkqmknnqqkrhmll	hmjskftmlglpkqof
oktqklhsppmjoslt	uqnjhfprikohulgo
oktqkthrppljoslt	ghoolhosoihlrfrs
kppguonmrrrlppru	irqufhpugrikqitm
kppgugnlrrslppru	mknmjhsrqhtiurli
ploiqmtnjufqktpq	opuigttuthsghjfo
ploiqutojugqktpq	lqfpllfgrlgnugsq
grjljhlghghmkpto	rguusqlsppltohkn
grjljplfhgimkpto	lkuhrptmofrsmjop
lpumnffpfoqhqttu	gqjmkqjrgjipljim
lpumnnfqfophqttu	pulhtiithnhifqsq
rjrmtkgjmhhulrgl	tsupjunrljnljrlj
rjrmtsgkmhiulrgl	nhjflupgnugnuisf
ufutikihngpjogpp	okihlpkfoufmhmil
ufutisiingqjogpp	hrlimhtognhqltfm
rukhuligiukhllnm	upohoouglujuhphj
rukhutifiujhllnm	kspjiurlplilrush
piffffjrtpflmhtp	ksnjfmrptqnnqtfl
pifffnjstpglmhtp	tfqurojgptnkgjhr
urtmfrplgtoojjip	rjkhfrnjnggtgijh
urtmfjpmgtnojjip	fkhimoglkpfofrnh
gtjfnjuhotugffmp	spljkiksgkhijtlg
gtjfnruiottgffmp	umpuptqnphqqqmgo
lhstnggqupmtfmiq	mqkrplplisoirkik
lhstnogpupltfmiq	iksuujjkqskpgphg
fhoootqgriqskkpi	ksokootofmrqkqqf
fhooolqfripskkpi	otjqrrsushiloiog
orskkjgrgrplqjsg	uiqmqrskkrrkmmnj
orskkrgsgrqlqjsg	kiqqtuqrsooopmri
ujpnrhskojmlpkjs	hqnqkrktoqkhrqmr
ujpnrpsjojllpkjs	tssphmmsomsrsjoq
trsouosirtrjikfp	ktplrkjkpikfjkos
trsougshrtsjikfp	fgqjgqlmqfgrmgkg
rntqgnqiqpkimlqh	toipthufqulhkrqg
rntqgfqhqpjimlqh	spjskuugimsjioho
fhsitomnkuqlihfi	nmkrqknokqfjkpog
fhsitgmokuplihfi	gsmurkhtpgpfhimm
upmohljtpipprnqg	fuhipmofmuokpmrf
upmohtjupiqprnqg	tmhhlnfqslmkqslq
mipnnmlmslumnmft	tlhqfuohjkuqguko
mipnnullsltmnmft	oqfqjrksroqlfplh
lrmhhkufshrkoljg	jiprqrjnmqhskslu
lrmhhsugshskoljg	knrfmgthojrnthop
pinistgumufjonhu	puuurrrkuuhjiqim
pinislgtmugjonhu	rrrqufurffhjrqli
jqthngthjtknhukk	jtskgiiinjlgfkkj
jqthnotijtjnhukk	tutuololffljipmq
qoritihhpgtqspul	uhloohiqsnmslffs
qoritqhipguqspul	iknmuilrhjiinoup
mpjsomppuiorpgsh	fosprpmupntqsomm
mpjsoupquinrpgsh	rmorqkinhnprqolt
fomstrjojlpskrjo	mkmlmgopnquotjkk
fomstjjnjlqskrjo	qkrlqjtirqtourfi
rorhkugpqlqtimpq	fgunltshkmunmurn
rorhkmgqqlptimpq	fftsjhlgfhhosrff
lrjpgtptriogtiqt	roomlkhmghmonhku
lrjpglpuringtiqt	iprouuuujqgopopr
rrlrikhhnurjhikl	nnpkugrklkuftqgm
rrlrishinusjhikl	npksogihifhrluit
qhfnkjgujipjplkr	krrnplpksojhuuig
qhfnkrgtjiqjplkr	jjnmtthjuskugmig
gqqrgrutitlkggmu	uutproqonsngphpt
gqqrgjuuitmkggmu	kolgoojqiqsongsn
nspsujrkupjimoqj	tsnhqkghkumffrrr
nspsurrjupkimoqj	hoqmruqthsumlpgs
tnuoiillpolhusom	ptqsukjhsnpuponf
tnuoiqlmpomhusom	tqqttrkrpupjigjo
grhhroujkonrmrul	tifssjmqqojsnuti
grhhrgukkoormrul	knmsjstjmgoqrpmm
mpgjsholmtmknstt	qntjlsohigfskfgt
mpgjspommtlknstt	kgslfsmfhukhqnhn
pqpjhuofmurquhnr	njtojsjhgpgrhkff
pqpjhmogmusquhnr	hqgspktulohomssj
ulorihgulsqnlmsl	fimjjurortslpijl
uloripgtlspnlmsl	urujtshnpkrsofhl
jrsrgjlhfmfplmrm	guhoqqplkghppjpk
jrsrgrlifmgplmrm	fjjlflhtgnlkmkui
qhmukmqlrpsfouhi	miujjgqsopuimjmk
qhmukuqmrprfouhi	hiqkgflnnjugopno
mgkjnmnnfuqpsgnl	guunkjsukmprjkfn
mgkjnunofuppsgnl	tttrqogqmngfllgo
hjupsogfhpjpjlug	orfufqnltljiqork
hjupsggghpkpjlug	mhpfttmntjsillmn
lpgglnouhljkmgtl	ghkgjmmfhrfhplnn
lpgglfothlkkmgtl	mjuknofmqfomsmru
fuoiltrfmrnjotis	ijrkpgpkmrjmsrkl
fuoillrgmrojotis	kojrrjturqiuikli
psligjqmoljlufoo	qrloopkiolokhrmh
psligrqlolklufoo	jhkjfkjpgqorpogg
tggfkthpulmgmnni	ifrnthsjpfgoqupf
tggfklhqullgmnni	sisitlrjjuujsmfp
trmjuisqsignomps	komkmfsfoqnkkfgn
trmjuqspsifnomps	hkmhmkgsnrpolmfi
irnimmmqqusmojmg	nfqrktjfqpknpmuo
irnimumpqurmojmg	tpqploqnoqppppnf
hkqushknpgotpfnf	onigihhuqotqrskf
hkquspkopgntpfnf	ituqrnlflqtpggik
mukjrlmipitonutu	fonrlmmfrkrsgltf
mukjrtmhpiuonutu	nqrhtrugtnmpmlgq
jkolgftuhotsputj	opoqjujhrsjtpumi
jkolgntthousputj	oqqfpljpqnohlgfh
rqpjjrfmjufjqonr	qglfjlrkollnhmus
rqpjjjfljugjqonr	lmpngikkggurmgsj
rnmnuronfjfthpof	kghljpfqpqtgngpr
rnmnujoofjgthpof	ttonnfmnmgmrtrtu
tmumljpsjqlrknlm	hpihqnhtqnpgokmg
tmumlrprjqmrknlm	jgmhrofihnokrjil
gsfqqsihgkmjlgrk	lslisihuougrfkjf
gsfqqkiigkljlgrk	rffnjikjhlpiiohm
uoqrhgnqlouqhspq	ftjofmmomngkimpt
uoqrhonplotqhspq	jtmtjnsfoknosios
sqqmokpoktqsfjjj	qptuqklflskjugrn
sqqmospnktpsfjjj	gfngosturgnrosgq
qsnmnrjllmfhpomh	ostpqumiffsnitig
qsnmnjjmlmghpomh	lsmniltsrmjsfgrq
umrgluujnrihnlup	jfkkkggnktqkturs
umrglmuknrhhnlup	jjsjjkfspujrlkgp
tnfugjrjsfrunkoq	goofpkfqgqkomrip
tnfugrrksfsunkoq	hhjmqtpmhokjgrll
usfrhlnjungkmofh	mtltmojhqmjlnpph
usfrhtnkunfkmofh	shuoojpstnsghott
onmmuirhrhirhkkl	mpmmrrlrhnlhusto
onmmuqrirhhrhkkl	lofhhpgghkstfllj
orfrkhmsrqmlhftg	ihurqmskohonlqhq
orfrkpmrrqllhftg	prmftntjrpunsqsh
mjflmpultkgjslnq	susohnqiujsgrpqm
mjflmhumtkfjslnq	ikfnthkulsqittgi
uippuskgjtgstskj	gsiqksjuhqrtftpt
uippukkfjtfstskj	ulqllompifjfhjsq
nsmnqfhsmqpuigmk	jritpnhmirhghpkm
nsmnqnhrmqquigmk	utknouppgqmprmqp
lljrmmgkknkitjtl	fjnmgimqpgopkkgt
lljrmugjknjitjtl	rupgmlpjfkpolnqj
psnququgnsngrmli	mggtnhokmlijhpgg
psnquiufnsogrmli	qggruitkiulipnmm
ujplhjnossuolgtk	ijqpmqpmkklnrggj
ujplhrnnsstolgtk	qquisgiufrrosirh
iuthljnjmsrnlpst	osjlnkisjmtsokif
iuthlrnkmssnlpst	hqqjtqoinqjfnhpf
jrmokungjfpmkfsf	pikpisuophptstms
jrmokmnfjfqmkfsf	mulqqtghnfslpflo
flgskpmqptuskqus	luolotgkgrfhfpjm
flgskhmppttskqus	fskpgggohpqjljks
hklsqgufnhsqllfg	flpkgmjmlignosos
hklsqougnhrqllfg	rsgfrmhgqjhprjqk
kktgljqfklppkhhn	nlgmukrihrgqulkk
kktglrqgklqpkhhn	uhhliomrkolrsmol
gltmrporgshjrlnn	jiojkgpnrklrootl
gltmrhosgsijrlnn	orkkromihtitlqiq
lsqonfsttgfumqmt	qnfuulfrujltqllt
lsqonnsutggumqmt	ltnnfonjkijmhpgo
ofupfqsmusotqsnu	gnogisgqphomujig
ofupfislusntqsnu	nrmjrukpfpsipsnt
hjkmjmrrlqhkkims	uttqprmgoohorkkf
hjkmjurslqikkims	ghfjpmjhljlgjhls
nslpfflgjsjptjgl	mtugitqoipgsqnlq
nslpfnlfjskptjgl	ohmtkfqkulllnssr
gsisnriifigfkkkm	rgmqitfpsnpihknt
gsisnjihfiffkkkm	ornffmmqofffiqnp
kqppptrhtjuhsllh	fpjiimolfljlhfki
kqppplritjthsllh	qimhgsqjgkugnhfh
ogptojsllugisoii	fshjhkgqklhqjntg
ogptorsmlufisoii	ifhuholhojuhholm
ginqorjtqnfttsho	qnrmnqipqthojrih
ginqojjuqngttsho	tqtkrhpkrlqifqqo
rilijuunsthfqrjs	gmhgphkutnggmjhh
rilijmuostifqrjs	siffjqsilqskqonp
kukpflrupnmgfnpq	mjqlhpqflmsguutn
kukpftrtpnlgfnpq	tglumlgupgogqitt
qkjfmgrltkrrrfhr	krstirumogsqmnor
qkjfmormtksrrfhr	ljtuiphorgkffoin
lpntffprqksmhsrt	muskgrnfrqspjtsm
lpntfnpsqkrmhsrt	mpfrpffqnpmjjihj
ompsmpoqhrpmjmhg	fkqklfrsohijhulp
ompsmhophrqmjmhg	sjkimnpjmoolgtli
qmimgkktjnqjskgg	jmiiirhsmmimmslr
qmimgskujnpjskgg	mphjqhprqulglook
ntsuqfoiofrimtgt	moiomhgtjjjrtrfm
ntsuqnohofsimtgt	rnorflktfpttstso
pfqgsissloukfgfh	khpmumglkkpkhprl
pfqgsqsrlotkfgfh	nlmhlkkjfnrfthoj
timmhruuofloffoo	nkrjprpprrlpjqrs
timmhjutofmoffoo	fnljfhitsqpffjrt
qikoimshhktjstnn	ttjiknpmogskhqff
qikoiusihkujstnn	psrtqkfmppnkhqqp
pqhirljflljnrfip	jqfqrsgopojkkflm
pqhirtjgllknrfip	qlggnpgmkqmgqmfi
skupuqqusrtjqtst	rjpjqpnnuspruuin
skupuiqtsrujqtst	rfhkoilgnmlfsqnj
fptsjjgsuhkshfhu	joprpgmmfrlfgftq
fptsjrgruhjshfhu	qkhrgnhusnsnusum
gqqojounrtsgpkhn	kmqknkkogsojsupo
gqqojguortrgpkhn	pirrgspfspqukqrq
sthtkloftsgrprlh	srukkonrjhofgsik
sthtktogtsfrprlh	gklqofgionhksiqj
rjpmskonhpusqgnm	uphhhruhrssqsiiq
rjpmssoohptsqgnm	kljngqfslmuqmrlf
hqlkriogfkknkhgi	msiojlpmnfkjihil
hqlkrqoffkjnkhgi	omlfsltiffflqmps
lsfhjgfsfffitrln	plorhmitgignlihn
lsfhjofrffgitrln	klhhmsqotlfqftoq
fosriokfnrshigrh	lkgfguoftljnkjos
fosrigkgnrrhigrh	fjutnokumpolnqrr
mqjnikhnuofukijn	nhruusslrjsgiffu
mqjnishouogukijn	sqlprhgpmupkniuk
sonjltktimjsjmmr	lpnjliktiljskrjq
sonjllkuimksjmmr	mtifililiunlqjns
pskhfqsniglgrhji	jfkmtjikoiofnput
pskhfisoigmgrhji	ouotiqnrhogsrulk
tuikmnnootkssssh	pmohfrqnohrlsguk
tuikmfnnotjssssh	ukfjkumupjpgqqst
spjhlourssjrmtqh	tmmknnilofloifjp
spjhlgussskrmtqh	pgtjorqgotsnpogp
lfsnmufmogtkglrm	prlfiuripogqlfho
lfsnmmflogukglrm	tkulfsrjpkqfphjr
puholrinuoruruji	llgskiuksrtksfhs
puholjiouosuruji	ohpttonnhmhmohnk
mgrjghfgfpfmkusj	fkujllgjoqgsqksk
mgrjgpfffpgmkusj	mjkqfulmphhuomkm
otguqsihlmqilkpl	lgpmluofhsostjqu
otguqkiilmpilkpl	tppmtsgrtlfjhuln
ihputqpijnqouogr	lilproujqgugomhj
ihputiphjnpouogr	qgtlljislrgufkig
qfomnmukpqhmkkpt	sttrhnkppjmkplql
qfomnuujpqimkkpt	prghrgpgqllognrn
mpssosgqqipunmhn	qkgpltgkjqgmphjq
mpssokgpqiqunmhn	lsgttunmtpjlfnmi
smhkpijfflnghqfo	lmmpmlrnipthuihg
smhkpqjgfloghqfo	gtqktgjofntrohgp
rsjhtigpupgtqtgm	jmqjmpsksgiofmmj
rsjhtqgqupftqtgm	uohqljquqtrgjuoh
snlquhkrljsnsmjl	tukltilptupjrrmn
snlqupksljrnsmjl	urltsfkiksjkpotk
uksgnlrtkprhtpmk	outiqlsksirgkijj
uksgntrukpshtpmk	qulhnfjikjqtkufi
nmkkjfonnsjotigr	hhpqiqigohloopsi
nmkkjnoonskotigr	prhkuhusqklgtruu
ouiutgqokkponfgq	nnmltmjmojqltkqj
ouiutoqnkkqonfgq	fppjtporurfiluig
oufkljtqloouhhjh	nmqokisnmsqmupis
oufklrtplonuhhjh	njopipiplmqjnhlo
ouhftqplfrjntjpf	tilmkpkufuklmrsj
ouhftipmfrkntjpf	niutmgugkhtjkiqm
sjjsrushktiuimth	hnnolgufmgnsghmh
sjjsrmsikthuimth	gifimspiuiltkqfq
houhtojslqrmglqr	iunquogkthhmmmrl
houhtgjrlqsmglqr	mkomqfuqkhkpgkgm
iqunishsqpljttsr	lfsonpnoqoqrpimo
iqunikhrqpmjttsr	kupkprppjtfrkrfi
fofiquplhqfmtgmj	umttkngggjniguqm
fofiqmpmhqgmtgmj	prkitiktgppkstno
soujijfrnjrhpnff	nkpuonmkknuuglrr
soujirfsnjshpnff	gtnrpkthhrqmjqrh
uuslfqkmphniljti	ttrruglqmushttkt
uuslfiklphoiljti	mofokkpnsfgmgigr
htnopknsmiqkqrhr	gfpiruhutjmgiugm
htnopsnrmipkqrhr	qmlijupoqnphhmhm
slqsgugiofplulls	rmgnmhtnkiouiunj
slqsgmghofqlulls	jirlismqfotftfsu
fnmmthopkjkmghoq	mrputngljniiuoos
fnmmtpoqkjjmghoq	inkfhjnjigssulno
lsjtkssimtilmlnf	ihnmlnttjmgshjjm
lsjtkkshmthlmlnf	qmrofffugniiigkt
qlqtgmqofhjhhmsq	khupglqolmfhuopq
qlqtguqnfhkhhmsq	rnhrmoouusuqniir
mtunljnjspkupqst	fgginrtnsfnllllr
mtunlrnkspjupqst	lnoqtfppqrltqfug
lpqnmoossgurpigr	shfjmlpgmlugtiuu
lpqnmgorsgtrpigr	umstpprqnfouugru
oqfofmgtppoktorq	jtshtslrpofhrnfr
oqfofuguppnktorq	qnkfiufrntkpngqh
plkisftgmqpjhssr	srhgmjqhukhsspls
plkisntfmqqjhssr	ppoiqmmknuunjkkk
mlflfjnuukrikskg	sspfgfiqtkohofjk
mlflfrntuksikskg	nklmnqmulnnljjtn
omprnitsgjsorffn	plpnrgkfplflkiqq
omprnqtrgjrorffn	thkrflqpptihtljl
qoofimrlqjrqkllk	kqftrqoknpgniftm
qoofiurmqjsqkllk	gtqlmpipfnugouqo
mflskmgfohpqptmr	rjpmkpjgtpkrpnkt
mflskuggohqqptmr	gsiqlrrufimqtirs
stpkmpplmifouofp	rsnghoqkntqrothg
stpkmhpmmigouofp	gooouhkkpfogrukt
inruougrhjisuimn	iqluhkqrlojmphqt
inruomgshjhsuimn	qstsmomlmtiktooj
ssqpjjtnfnstpmjp	lkugshhnlhqltssf
ssqpjrtofnrtpmjp	uqjtlkjlqomojhsr
isnsltmosmqjqhss	qsphkktkkformqgt
isnsllmnsmpjqhss	pottjtltkppnlimf
nlluhkuhmfipulmq	rktrrrpjiftmiqqt
nlluhsuimfhpulmq	ifummqnfrlitlkrp
ojskknnkkoppnrpg	kjpumksnfhqrurfn
ojskkfnjkoqpnrpg	imfutrpqrkjoslsn
fkqopntrsfrkriuk	jliqjipktqhfnqjs
fkqopftssfskriuk	ohohtgkhujphrhkf
fqqmkjjlsifkqhor	lrggpmlniqgnlgkl
fqqmkrjmsigkqhor	ukttpsinjilnkhlh
qflglugmpphgihir	qrmifuhqismflgsg
qflglmglppigihir	fpgsnshuljomrrnt
tkmkhtsffmupffor	ltiqjjgtfspsttls
tkmkhlsgfmtpffor	qjtqjjgqlshnrrfn
thlhjmgutnumplmm	mmuimhknugohkhio
thlhjugttntmplmm	nmkggmliiiltlkgn
qlkklqqjmjoglhjo	rstpfkrpupfnqtmq
qlkkliqkmjnglhjo	tnpmupjqquqggtir
gnsnknjukjunmnlq	rqihsifjjslikruh
gnsnkfjtkjtnmnlq	luhlsfgmhtooktus
onsojlghhqkrojkj	juffhrhuhjupkfrl
onsojtgihqjrojkj	mlftfqmqqkjguppl
fqlfqqhinmufmhsu	hunsrtpopfqupqlm
fqlfqihhnmtfmhsu	rlsphtigrojpqful
rjtlorkfqmlnspoh	omnmjsqnmrghgjgt
rjtlojkgqmmnspoh	mhtghgsggsomqnoi
gqottjrrfjfrsnmu	mltisfqstjpthfmg
gqottrrsfjgrsnmu	qmngipgirisnnsig
rfgktuqjpjnfrphk	kkqjnutftfkpufrg
rfgktmqkpjofrphk	iugkoktumgtkkmsk
spflhlunuimrossg	mjgnrngrnptuthsf
spflhtuouilrossg	fttrsmtugoqggtsr
hfhhmopjrkoqknjl	jhihirhgmfrhflmg
hfhhmgpkrknqknjl	friqgspsfijrunnk
hkoorknhuitkmuli	gfuorspqgiqrnfoh
hkoorsniuiukmuli	jglkuqrqskjhsjug
njlofsumplrkfskj	urmpiotqrstlhjgl
njlofkulplskfskj	sggjjmqpinrlhgti
fhpuhgmthshpjloi	tpjhjlnghmhgllot
fhpuhomuhsipjloi	iqttskiktoluoqts
lofhsjlgfnrsmnhs	lktjhnhuqfmnijiu
lofhsrlffnssmnhs	jtnstommrsojfssu
jijipnhlrqsprpmn	otkkkprsrnpnprtn
jijipfhmrqrprpmn	quohsmqosfmgkhnm
ulikognjpoipikmq	skisgkufmifmttji
ulikoonkpohpikmq	tgiurmnrtqgqugoi
ihfkgtnoiokmkjpj	tipnksirknkunurp
ihfkglnniojmkjpj	qkqgqnssksuhuffu
rgiirqglopnkqhtt	fnoqmtffguioqqjn
rgiirigmopokqhtt	rqigrftnmosfhjmk
tprmhjskgqnfthjh	huqsmkofnkijkqnj
tprmhrsjgqofthjh	mmqnoqoslsfqthof
rqrorhjpoguurkuq	ffnhomlmqktpgrhh
rqrorpjqogturkuq	gilojjqiltmtutll
hmirfgnlrnhhhgqf	hmssnhpspsrrojtq
hmirfonmrnihhgqf	muipqmomothnpnni
mgusqlkruiqjsftm	rlqjitflrqiikkkg
mgusqtksuipjsftm	phgutosuphmnkhkl
orkgmslkigigrsgn	iqgfjfrhhppjhnih
orkgmkljighgrsgn	piqjhjkilkgislsm
omjqupgsjokkqlko	ittsftstmgpiiunn
omjquhgrjojkqlko	mugljrttolgglhpf
pqfgfrmjhhpuukmi	osuqiqmussgnjsnj
pqfgfjmkhhquukmi	nprpmngnqolhmlst
ttmkopffprpftqog	mkmkimkiupufptun
ttmkohfgprqftqog	upuqplispplhnspr
iqnjshihighhhhto	jlltjushtjqkuguf
iqnjspiiigihhhto	kfhofjrfkorggsun
jhjitmmgojtikkou	nspmrmgljqfogtkt
jhjitumfojuikkou	mkonhnpjhlustfgs
mitsnuotfqptlkur	nsulohrtlgjglull
mitsnmoufqqtlkur	pjmmfppopulkptqi
ussosnjmopuuurmg	jhkgrgsrslnuoqkr
ussosfjloptuurmg	lgllhipqtpnqslmr
mrogpqqkorokunnt	lsgsiruikrfopusn
mrogpiqjornkunnt	kjhnmtinfnitjmlg
tusihptkikksshof	grumjmpfpquinqng
tusihhtjikjsshof	gjkmtjmkgmtsngjt
rlqrsjgsnonjilqu	rmmigsigthrtffhs
rlqrsrgrnoojilqu	ipgoutishuphhfgu
qpriojhfnspttqmt	munfkjoppttghuiq
qpriorhgnsqttqmt	flqgmiqitnhkgumu
stuhsoskuptuiflm	mhlnpfijnmqmlirm
stuhsgsjupuuiflm	rrljntisukpmgknj
jupjnhtmfjspgrmu	jfmkfmiqjqtlhijj
jupjnptlfjrpgrmu	ljpjrsmuhgqmuupk
liptffsrqiiothrm	ggltknnmsuljmitp
liptfnssqihothrm	nrnhpngplslhjkuj
tiorhmnmqrsgnfip	njkigqhhmpotnuuj
tiorhunlqrrgnfip	rkfggloqokpfsiip
tmhqhgfqgimplrpg	ffsnhoktkrqkouso
tmhqhofpgilplrpg	pplrjnptrsruljjt
ufnuqtluiuiglgpf	kjugmkfjjompfgpp
ufnuqlltiuhglgpf	kjtuhshifkplihij
nhqrlpikfrtiunho	hooqtglsoqrshmpg
nhqrlhijfruiunho	qhnjfjkprufpjrfr
fgmrmqnnhjhnkqkk	imkqhujpqhtsjqth
fgmrminohjinkqkk	rpprjiujiiuuqsgg
nulolirmitrffsfk	qpkgpqulhtqlngjm
nulolqrlitsffsfk	onsmqgrmnttornlk
pqjsttqhkgujnkgo	kgppqiomosuitplj
pqjstlqikgtjnkgo	urnnilsgkrfqfqos
kjigfqmnnsukskor	usfmlhltookljgoj
kjigfimonstkskor	ikukhkqfltipttpo
hmtsqhmflmtnfhml	lpqmlqmsoroujnms
hmtsqpmglmunfhml	nrprfsqrgimjqulm
ophsufqirugolhuu	ggnsliifnliunsou
ophsunqhrufolhuu	nqtqoslqkutmjlsg
uopfinkjfomloumq	lmiurmgofnfligkk
uopfifkkfolloumq	rsufnfkrnrniifqt
iuhjrniuhproopph	itgktsokmmgjnffn
iuhjrfithpsoopph	tnqqqqtorgifsttu
giqjkpiusirjiqml	lnuhsrgfhuonouuj
giqjkhitsisjiqml	rrupttljkkulftnn
jfhijgprhlghgfqp	pofptrosifsnghhn
jfhijopshlfhgfqp	irffntqosksfnpul
ffskrppmssofjimn	utnjjhiuqohlmrnr
ffskrhplssnfjimn	kppqfmjftomkfhpm
fiqomfngisflnqun	ukkkkfrgisfmhfuq
fiqomnnfisglnqun	fhpqiuuquhjjsksu
gsnggnfhqlpmgpqp	nkfkgtqsgthltlmu
gsnggffiqlqmgpqp	qtojiuutluntgghs
lhsphotnoiikpsqk	toohstgothfpghth
lhsphgtooihkpsqk	rsinksrlglrhgnlf
nuiupsplftpjshhp	jtrhgjrurlipsnjg
nuiupkpmftqjshhp	snftfftokkghmgqh
umqjrlrtsnnltfil	iupogkjiimnnkhmo
umqjrtrusnoltfil	sjgiphusststumqn
uupstiknnopghsup	gmmtqolmmrqgsjoo
uupstqkonoqghsup	skqoiqjsomofpjpo
igkksffighkmoptg	kpiimnrhngigphgi
igkksnfhghjmoptg	rsupnostrjupulpl
gmnnshrgsftusugk	mofglmghlupfmkgr
gmnnsprfsfuusugk	nkuqnjgjhmsoortp
umuuisktosmmqmup	mlsfgjmrfqrkjflu
umuuikkuoslmqmup	nkiqunqohrrhukpu
tgffikqkqttojntl	moplsinlflshlrlf
tgffisqjqtuojntl	tqrujpqhonmgmjol
hllluojkgmpfggui	opqtinjglnnnmjmg
hlllugjjgmqfggui	lphijunspslkimrr
hjqokruslrriopsj	tjsnljokrsluhmoi
hjqokjurlrsiopsj	rqgriotisjhmkuhp
johkjufrmthripmm	rfltpgquspipoopr
johkjmfsmtiripmm	tmritptnfjikunrm
lhitfqksllhnmfst	jkgsuisptstjpsjo
lhitfikrllinmfst	gjnrtltntkinhpnp
roqsssioikmtofuu	kjkpunrmijnlrpjp
roqsskinikltofuu	qmokktloshhirijh
pspruumugkjmtnnt	rplgshjtmfthqqmt
psprummtgkkmtnnt	rpptmgrfhqlusifl
gtqsollsljsopsji	lpgormsgmgmguuuu
gtqsotlrljropsji	ohlpptgtthhtjqri
khqufkmlsrkkoikh	jglhhrkkiurmiokg
khqufsmmsrjkoikh	gsrpfqhqrpnkfitf
shoithiqqnqpokmf	osijjhplslqirfsn
shoitpipqnppokmf	hjumrggnjiprphpr
ufitugonkskhgfpg	qjgunkmhqkfntosk
ufituoooksjhgfpg	ounktlootuthtuft
ustqfmplniuulgft	soprlrotnhmfkknp
ustqfupmnitulgft	gmllfukglhgjqmqj
ltuuhpinnmfgggtf	mrignomlomlkskhg
ltuuhhionmggggtf	lnikrkufkmptrjks
ikohtmtlfngogkii	hpijotqtsjusquis
ikohtutmfnfogkii	lgffqqtsfhfgglgf
qjqrislkopiijqir	hoqnniprmnrqlosm
qjqrikljophijqir	qpkikhfpokmjmmrf
lhffntgitsisjkhr	jguooujptinqfioh
lhffnlghtshsjkhr	hlnpkpjglkjsmrqs
glulftrtrmktkfkf	ppmslnskfshnlofo
glulflrurmjtkfkf	nhkhgsihuhmnhhqi
lmjnipougpqhrkij	hiitmornrkughijp
lmjnihotgpphrkij	othkiihrsujqusuk
ghtfkqmspituofln	iponiliptmrostgj
ghtfkimrpiuuofln	riposqhmlpojspgi
gmltitrqrngruhnt	sjroolmjgqhkmhms
gmltilrprnfruhnt	nkpsfputjphoqsrh
pkqpkljnhnfuhprh	fnstsgoufplgkfls
pkqpktjohnguhprh	lgimfhjpqhfnmnfp
hhnsifmilnqorplh	rntsqhjujuspkkrp
hhnsinmhlnporplh	tlkonfiltmopuljf
uhtsjpprmnkrmghf	iiosltggjqfurjrs
uhtsjhpsmnjrmghf	mqkilshhqnrmkljt
ltrlnlpfnsssijps	ngthkgkljutfqriq
ltrlntpgnsrsijps	tkrmnhhkmqnriluk
ulkntlhhplojftps	kgqifumjjkqghgri
ulkntthiplnjftps	fstmputingighloi
fqprrlmklhrtogmg	hpufhooupnnsjtgs
fqprrtmjlhstogmg	gprpgqnojugoqtfq
osmjtnsnstgnnhnp	pnnthglhnsutrlkn
osmjtfsostfnnhnp	rsisqpmutnnrtgpt
oltrthnrkfrkjqmg	lkupsisiumhqnuii
oltrtpnskfskjqmg	fkmqlolgsmqtnujr
ukmkfhpnhhtnmiog	qjhkqklkqfhiqiqg
ukmkfppohhunmiog	juslnrsltnqhjkfq
jplqjhuslfgumqil	fljuhqsnjpkfqnqn
jplqjpurlffumqil	rpunolpkunjpilmn
kssquiqgmptjursr	fpqlitorojpilmjn
kssquqqfmpujursr	grtfflgmkitopokk
hrtokqshkpqpkgss	uomfpoisosimgrmh
hrtokisikpppkgss	trfqgtpjqspfgpnn
gflgnpujthnhukmq	iufjsfuurrokshui
gflgnhukthohukmq	ptfhnssksqfuropl
imiogqgjogojoqqj	kihkfqjqlnssfful
imiogigkognjoqqj	knfpoqktokgimklq
krqiuluqfrhusmkt	nfuhopksftnlnoqn
krqiutupfriusmkt	pfjiruiffjrhijmi
jrtisstskfgjgumt	iqktfliruufoprmf
jrtisktrkffjgumt	oirghpiiokhlqoth
qttonkmfglrnoorf	roipuinpqsgtkqpk
qttonsmgglsnoorf	nsqnlofpjsglipil
urlphrlutglqotfj	ppuunfjhsfriopjm
urlphjlttgmqotfj	ungiintqufgnhijo
oqujhhpljjouijmh	fotklghtfqfrhmji
oqujhppmjjnuijmh	ngmiomnhglfpumgg
nkqtjuttuksghtjl	pjjppghrlojhmisn
nkqtjmtuukrghtjl	ntijpmogpnqglnmu
ninuhuhmoltitkss	hgjpptkhlonklsfh
ninuhmhloluitkss	ngktqftjnrnthkuj
ihqfgjqigtkusukm	flmfqqoqiunkqhsm
ihqfgrqhgtjusukm	ulsguihfrufkurkf
puiigklpugkmopit	qfrhijhgntkgsfok
puiigslqugjmopit	mjppiohjnfkgukqm
kjttfrmioiulhohm	olqmhrnpphuqmjsl
kjttfjmhoitlhohm	hisffhinonrlmgrq
pkgfjjmgllggqijf	mqjguiojftrfftgo
pkgfjrmfllfgqijf	lgsugsgoissmjkun
siorunlfoqntmolt	ngrpfokioqgrgnkq
sioruflgoqotmolt	rjfuokiqhhtuspls
rjlsurfpniisjmnp	ohfsnkonunoqqjms
rjlsujfqnihsjmnp	lthhkprrruttjqfm
skhjjhqolpqkojhl	qkqqgjrhlghqqjfj
skhjjpqnlppkojhl	kmglguigkprjhott
jugmpjfitogntpol	gmhfpgskuqruhuho
jugmprfhtofntpol	gmisprnlktpisfqj
kfrtfmntlgmusumg	ifrrshjngqphprjg
kfrtfunulglusumg	qruhfquggiohkmjs
gonplqsrruustppi	pgugnnfjpnppggui
gonplissrutstppi	pnjjntfpjskfqthg
ftrhjunjiujomsjf	qrnosimsphstflsr
ftrhjmnkiukomsjf	qjlqlhfhokpqlmqt
soknioujknrlgrmr	lfrhukiqlpmhfkif
soknigukknslgrmr	rokkpimpniktmsst
guhnlkupskinnisu	jqhmphqfmhihnuuj
guhnlsuqskhnnisu	rfimiruoiirhlkpf
rthqokhntpkgnqmo	uprmqhkrnrtnismr
rthqoshotpjgnqmo	lufltlgirqoirqjh
qrgqmmsplfipijgm	hhhrsikmstptjfjg
qrgqmusqlfhpijgm	uotfoklffopqttqn
tjuojonotfgkqgpr	pgotqugoirfphtig
tjuojgnntffkqgpr	orrgiuurtitogqfl
jfomkljrnpgjgsih	fhsghqgjthuqfstt
jfomktjsnpfjgsih	qjogpsqsostokksm
qomugrlkjnjnkfgf	oumtpjifpkumjkph
qomugjljjnknkfgf	msumlmimqnpkmiqp
utqsktqgusqfompu	tmrqpsjgjofrjfou
utqsklqfuspfompu	tloqtnstpoigimku
uqpllqofsujhfmkf	fntorghtsnsirllu
uqplliogsukhfmkf	iunjhunrutqqnujr
rkfmnfgptjngjfrq	fluhjgjtputhfotj
rkfmnngqtjogjfrq	jugfhtjijrtmonot
ihjkirpgpunpugio	rsgtnhlgfsuoillu
ihjkijpfpuopugio	toklpttpplpiifrm
jfsjkmntuggmoujq	iggtrsguutojujrm
jfsjkunuugfmoujq	nutrmirtgourmqfh
ksristlhsgmlqgkn	pnhshllussulnjph
ksrisllisgllqgkn	pukpqluhplfjqrto
jskinrsmiknphmki	njhnitnmflnrqklu
jskinjslikophmki	gigiiklhgflkrfgm
hgolkfhhijsqnijq	gmskprhqujjuikjp
hgolknhiijrqnijq	onjtljphkrlmilfm
gtohrhikitiiliml	jitutnrmrgpotihf
gtohrpijithiliml	rgntmhkuoroisipm
glogrkktiknunrml	gojmguhlnhrqmntu
glogrskuikounrml	ooqthqnpuhfituiu
inohrsijprnrpttu	jmpfiitsgmrmmjgl
inohrkikprorpttu	jqhuqfshihngkofm
jsqhsmsqjrsoojul	rkmrqlrfjjhmmlsg
jsqhsuspjrroojul	ppsitjmqplotqmjf
hmglnjjfnfmhmgoq	qmrmlnlshugufmpi
hmglnrjgnflhmgoq	krrsfkfjlsljfngh
lhikglfgosktimtj	pfqpnrrlskpirifh
lhikgtffosjtimtj	omottlnnntstojms
snslqisfqkhihrln	kukjkikjofunlogt
snslqqsgqkiihrln	ktfijsrnsttghfnm
ioffgnrojmtrglks	popguhtusgtoqglq
ioffgfrnjmurglks	sgqgqtshfopijflh
mrnuiqnhqlhtrffp	joioioglionfqrui
mrnuiiniqlitrffp	tqljkjusiirnkunl
kmguiiljnjnhukfk	gnuprgpjoltursmo
kmguiqlknjohukfk	rkuiftrgjigtnokp
gtifsikqtmoioksm	qjikhlgkqksnrpno
gtifsqkptmnioksm	uoffjqffrttnrhgp
mmnngppjhimqtggm	nutgtsuhlmtsqoqm
mmnnghpkhilqtggm	uqljqfmurqgorpif
qfrkjspmgfgtgmis	nfjhukqkmjsmoqoi
qfrkjkplgfftgmis	ifsiumjlkooookji
jhfqoqkhkskhkrfp	okuumstpmgqphqsl
jhfqoikiksjhkrfp	rglqqgifrkltumip
kujirpsofltnnruf	rpgqtfjpsjrqilgi
kujirhsnflunnruf	linlkglhfgmutnpp
tkqtnpmfsmjsggtj	inokustifinokluu
tkqtnhmgsmksggtj	mioiiurspfqqmrtg
itlomgjfinuroooi	nprglninjqspkhjk
itlomojgintroooi	ffrqkgolptmnumpp
pmrkprphrfgolhuf	pjqqlihmrlhimpjg
pmrkpjpirffolhuf	qjtkqnikspprusjm
sphrggnnmfqgofop	msrmjlluupqhpioj
sphrgonomfpgofop	sifoijtlgrfklftm
hikfhshlnriihhuu	qmtiinijlpnshlio
hikfhkhmnrhihhuu	gpsjhfjslnkugnri
tksqnugioshriknj	qpngpohflgnorrlg
tksqnmghosiriknj	ggglimruimurjgpt
njrufurnsnrlhsli	inrmfiqjuuqqfurf
njrufmrosnslhsli	ptlrutmgnihroour
mpnpuhojsomfpqjf	htlssoufnrtnmumi
mpnpupoksolfpqjf	ftiplnmfuhmjhshl
itkmrlmokojlklhq	luhjouiqufhkuqig
itkmrtmnkoklklhq	sjqkjgopimoghptn
hjhoqmnkmrqgkouk	rgiiktmgmppissjt
hjhoqunjmrpgkouk	tooijnjqnmgpqjuu
qrokqnlgpssmhlkm	runjtojsjkrptoth
qrokqflfpsrmhlkm	igkjrrujpntjgjsq
mfgrutqgpgkjhqfi	mujughknlhljogrp
mfgrulqfpgjjhqfi	tjkkhkrokolikuoi
qttqlnghjfpijhij	pjknrfloquigmgio
qttqlfgijfqijhij	utgiqtsforgqoqji
lootgkllnsjqsrth	iqlnlkhgjfgoqifn
lootgslmnskqsrth	lnltfrgpmomtklkk
glomhpsihrnhjkmn	usmtgftgottjgfoo
glomhhshhrohjkmn	fgguptkqntufrqkq
orgsslgjuqprfqul	ljplkhinmltsqlqt
orgsstgkuqqrfqul	hspjtpqigjnkmmgq
npfiolktnomkqfqi	qjoknkislpfmsokm
npfiotkunolkqfqi	mlqnjqiuqpimjpgu
pjmtktuiprrsojkg	opiqolphuprnjkhr
pjmtkluhprssojkg	kikhrtgnrgmgqmth
jjqprknnhkhmmofj	mgjgorqtssjpggnk
jjqprsnohkimmofj	qffgijrltrfprhut
oophrpgortgtqqrf	untgkpoinfjgmntp
oophrhgnrtftqqrf	hpghqtmkfnmttnsl
jlfmfsptmnprnlrl	jjjiukolnoqkjntp
jlfmfkpumnqrnlrl	opplofmplnnpjunp
rqilqhghgmmuootu	ktmkkiqgmuqqhjsu
rqilqpgigmluootu	tulkhoffsifosftl
okokorjiqjgtqmqf	lopqghtmrrglnrlj
okokojjhqjftqmqf	oumhofsmrkqmruuh
hoiglnlhhtjuukjp	rtfljkostofgtqnq
hoiglflihtkuukjp	ftsigfpqgtfjljss
mqijrgkhshnmsutf	ohtfqsuqqltifhrf
mqijrokishomsutf	ufrnliirnroiijkj
jugplnqqfmftsnht	lnnruojiprngfnit
jugplfqpfmgtsnht	okuhisnljlkfshrp
moomjooissijsgmn	ujqmmonhplmotpns
moomjgohsshjsgmn	prmjprqffthrilig
knirhnkmhkjqkuru	nfuhmfrmsioruujf
knirhfklhkkqkuru	jrtitolosrsfihti
flhhrhlgltingmlt	hjumjmqifriplhks
flhhrplflthngmlt	pffspupusfungpgt
qghgrqjorpffjmln	forijngsmqlftoqu
qghgrijnrpgfjmln	fklptlkjpjojmkho
ktlsjrfshomutkrk	mjpiksrorlgugllo
ktlsjjfrholutkrk	poliujpngknuolif
utssiifmtnlfpkui	jsoljsrikuktlssi
utssiqfltnmfpkui	kikfisiqjomiiqmn
gkmipglkhfkjrujj	ullsfiptruphmstp
gkmipoljhfjjrujj	smplinlqjpkipmtj
hsgjottipnmispot	qirhirljknjhjjpi
hsgjolthpnlispot	knjruiknfnqsmnjh
giifqnklgiqifqsu	gsplpflirimsjpuo
giifqfkmgipifqsu	flopofggtppnsnif
qkftglumijqjsttp	qjjlojlqtnqijrim
qkftgtulijpjsttp	thhlgplushilmtff
tokhupumrtomjojr	inlmgfrohihtnult
tokhuhulrtnmjojr	hpqlhfghjlrkjlui
nhfimjgmffptrjpj	jkpsismpptkhfkhr
nhfimrglffqtrjpj	slmuqqimsmrqhfhm
rumhlhjskotspluk	gllouopljhluosji
rumhlpjrkouspluk	utjqqtmqlsjpqfut
fsmgtquqgtrpsgqs	onigutmlmlifjunm
fsmgtiupgtspsgqs	urorqiinokrfhtso
ooplfllrfjsrorjo	pfljtjkqjfltqpmm
ooplftlsfjrrorjo	pmlhjsllijuurmim
qumhlmgjplrfhngn	omhjgiorokifpjiq
qumhlugkplsfhngn	omggjimmnukntjhk
flmsnujiltfpoplh	moqmitfnlsgrrsoq
flmsnmjhltgpoplh	tkugsluttiklrtnj
