qsssmfqirrnpinrr	huptusmhsjioklhl
qsssufpirrnpmnrr	ishmnfrfusmtnlgj
fpntjsuqrnlkgmtl	jfqpfsrljgplqfmm
fpntrstqrnlkkmtl	fsusgskiotmlosht
rpsijitjupqkhmnt	lqlfsuthnojmgqou
rpsiriujupqklmnt	fpoofqhtkqhtkquh
kunjqsogjnkufinl	qgqhitftuuqhhokj
kunjisngjnkujinl	uufofpihstnuuqti
nqlkthqgiusmltho	lttfrmoksgkfrfig
nqlklhpgiusmhtho	uhksjrplkgspnljs
uqpussstkmgknipn	knntgnfnpiiukiol
uqpuksrtkmgkripn	hikpgkfghigitptt
ggsqugusktfhjofn	pqmhhpiftqppshjo
ggsqmgtsktfhfofn	qmprnrukkrssnfkg
sptjmuqpshihmltu	houirgoqugnrktqn
sptjuuppshihiltu	tuirhqnrjgphkpru
hsfgftrtfmlqkslf	lgorslrnnfjiskgj
hsfgntstfmlqgslf	oppmmkulgrnrlust
tfprrfngnmnslnok	lhrpjpjtfqlmopjk
tfprjfognmnshnok	rlfuiglmggtkljfl
iuntqnhgpsjggpgr	rnktlrtpfortnoju
iuntinigpsjgkpgr	ftqtqrkfmnonfslj
opshgimsfsigsuir	gohnormsnuhkpffj
opshoilsfsigouir	tiklttkksmluijqu
lgftoqpotujllknh	ufulomjhkgtrmkgi
lgftgqqotujlhknh	tjsfgnfglnnflkpl
rihhifrnpjtnfpoo	tnjqtjuphquhiglk
rihhqfsnpjtnjpoo	ugktflkghomukuim
pqhmkrqhulqmmnkl	nglgjrjmhsjsjtgr
pqhmsrphulqminkl	nsijlrflprqkikkh
pqslnhrtrhrifomu	qfqthikmfpjkjfkp
pqslfhstrhrijomu	orsltntpnkqijpkl
jhphsoplfjjknjlm	iokpfrlurptlijsp
jhphkoqlfjjkrjlm	olphsrofhjogsrnl
hjuinsjmrmpjgngp	suhkonoqkffgpptj
hjuifskmrmpjkngp	lqqoshumtkljoftq
ifrgolqgsrormiqg	ioglfutufmuogfmt
ifrgglpgsroriiqg	gslsnffukpgkpuum
qgmqggrrmigfqosm	nlotouhlqffotnpj
qgmqogsrmigfuosm	qqgnqjffhggkrmhk
nmqtmtljomhmjfmm	uololnuqjpqompni
nmqtutmjomhmffmm	pojfgosmpriimijp
ilrhfotjsuihnuni	fhjfrmmrgkhjlhll
ilrhnoujsuihruni	gfluqqrmospqujmn
stluuoqqlqipknft	tptgrtufuluqojuo
stlumopqlqipgnft	musouhfiktqmuuuu
ruhlphlfiigpriqj	khpknilkjjpkltgh
ruhlhhmfiigpniqj	tqphujgunrlljnqr
jmtqjnhtjillurrg	qrkjnlhiqqtlohlk
jmtqrnitjillqrrg	fgnqtujggmhftunt
sksorhimppqoitlr	jllkjqrnlpgrlmph
sksojhhmppqomtlr	mjrroqhrmifigltr
nnlmtsoltrumnumf	fhqinsmpolmipggk
nnlmlsnltrumrumf	gnqiqkmsukfigknh
pmstoisqktqqqipr	lnjkphfmuuimtgio
pmstgirqktqquipr	hruijifojtulujfi
nugpoqkksjulppis	iqlnnhfpurgofkpi
nugpgqjksjultpis	mopoojhhjihjlsms
rjknfktolnpnlsqu	grgrpnksokiripjt
rjknnkuolnpnhsqu	htktpikfjqsjkmgq
kgirnsmfjftkpntk	loplrpljpkornfff
kgirfslfjftktntk	lmgthjmhshrqktpj
kqmirumhofjggsip	jjmjortsfstighpk
kqmijulhofjgksip	oipnrhnglgfukogj
lfrrkgohthknhhoh	tsjmoshiohrpuojt
lfrrsgnhthknlhoh	gmtkumkqqgshmuuj
rjrjookqonojonrn	loqlkrnfokihqign
rjrjgojqonojsnrn	qitipooksffnlmql
ngjqnngilttipmgi	minfgorngruinngm
ngjqfnfilttitmgi	fhssjpgqoknhrslm
qtilusllotiifkgi	qmmpujmulmurgsom
qtilmsmlotiijkgi	pirrirhprspptgfr
nhqpiprqlhmmrsff	fkjlhphirlkolusp
nhqpqpsqlhmmnsff	sruminpkphunrfsr
hluiqlfptqnjmqlr	ikulkpmpqgmsqonf
hluiilgptqnjiqlr	fgjmstojhpsunpss
rffiijijlqlhgqim	qokmrkoipmnmtmjr
rffiqjhjlqlhkqim	tfrqghglhkgtfkqr
jgrflihonnmjrunh	ogrjpjpqjoisogoq
jgrftiionnmjnunh	tqnlqirrmtnthkiq
hhtulikmrmitqohu	qujujmhmrloljipt
hhtutijmrmituohu	fmsnnulohifoupuj
jporhlqqtisoshmp	ghfsqpkltpgqqljr
jporplpqtisoohmp	phfjoumqqkkummif
qtprffhigfuljkjr	hnhthguhthilfnpj
qtprnfiigfulfkjr	shfkfhpgmpqquqsl
quuhkgpkmknjhshg	mmmlnrntfptmrkmt
quuhsgqkmknjlshg	nplnmghhqohnkhsh
tsfmrtgnokpglkui	jogusqfssnprskgp
tsfmjtfnokpghkui	fpfmrklgfrtgogtl
jrqqfjtffommfnnt	oomsmhqmfmsifslr
jrqqnjuffommjnnt	ougjhhohqkushlnq
tgqqnjftmnmtfujs	otohopqflmhnrnsk
tgqqfjgtmnmtjujs	rqqqjkmjsfhhpjuq
prfrntujslshkrmq	kuilsnotroqnjjji
prfrfttjslshgrmq	itkgjrlgsgmkruio
tqopmutlofioinjn	psgsltmtriihtpit
tqopuuulofiomnjn	tpshlgrunhfnktrh
lsfnkqqgkstnifnl	ishiomrjtihmouhg
lsfnsqpgkstnmfnl	rimmhlojpmjrtkor
tfqpoikpjnlhjmlg	hhtjfnkgkmqithoi
tfqpgijpjnlhfmlg	tfjlohgjlfhssmtg
sgpsflkjlhuruqkr	fqjkgngoknishthl
sgpsnljjlhurqqkr	ifhnjktomjmqiqoi
pltistjgnrrgmimj	hlgjtsijlmpojugf
pltiktkgnrrgiimj	kgogpfnrlfpimumt
kjrflfjgogmlosrm	pujmhnlrgrimuksm
kjrftfkgogmlssrm	mhmtnlfpphumoqkk
ikngutrptirkuiqj	iqqnrrplplonlkhf
ikngmtsptirkqiqj	itgfqimnkosuorig
ujrljforjgtpjjkf	oqsqmkojrkksiolq
ujrlrfnrjgtpfjkf	tgjgsjhooorlfqpj
sipqtpktmpjmfngk	hhhmnljohnnhlonl
sipqlpjtmpjmjngk	mtiqtrggirsrpnhk
lrquqnnjsglhsqmg	olhugujqrqqrjqig
lrquinojsglhoqmg	qfphrfnfnhgukqgo
iptgkmlskslgojgl	tuqiurgisfhjgojn
iptgsmmskslgsjgl	jusmqosofshstmkl
ktrlqskfjuimooqn	hnimugmjhplngsgg
ktrlisjfjuimsoqn	tnisqjupmhqrugnf
qmithrolrmouqnrj	npogfiggooqtfroj
qmitprnlrmouunrj	opkmmrmgfkrkjjuh
imiotlihqrskigku	sgjgkuhijrrtmooq
imiollhhqrskmgku	lmmqfkhlqusolsnl
hjlouogjrtjmiifh	siotttlilnmrkhff
hjlomofjrtjmmifh	lissjklhfplmsllj
thgnfrrmllmukshn	tsqsuutmisoiiigh
thgnnrsmllmugshn	tjlngrpgstkkkirg
kmfjlljmqmmsioui	iiitkmgjofhhmhhg
kmfjtlkmqmmsmoui	rtlskhiinosgupir
njqfnffqhfusimkl	qqjhfpmupknousrj
njqfffgqhfusmmkl	ujkrurpousoohtpo
kumihkjfsjugptri	khthigugtuiiugnm
kumipkkfsjugttri	qhjtrrtloogsrjtt
smlthuhiqhkpifgl	oumhfugrgsrhtgri
smltpuiiqhkpmfgl	jognffhrjjlsfgok
flpifkstiothjpnl	ngtruornknmukmip
flpinkrtiothfpnl	riispmkntmsslugp
nhmmijpfhkfgughh	iltfnoslpkoqtkpt
nhmmqjqfhkfgqghh	stgjtlgipnrtpfns
tlqrsiousslknpju	mjmtroftfhkmkhpo
tlqrkinusslkrpju	rgirsptmjujhkgjt
jugfkpsgmfsrmuoj	pgmspmhmoiutrrlh
jugfsprgmfsriuoj	rjtufhnmffgslknt
hrgihjgpfophskjf	skohjqgrufhqfspl
hrgipjfpfophokjf	rqfnlmhkfttlluss
stptuhtrjqhpifip	isforpqsnlkrpnjr
stptmhurjqhpmfip	kfgnpnlfofuljufm
ojjkmntogugoukhn	nofmsfkuqnmghsuh
ojjkunuogugoqkhn	sjujhtojhmhuiknp
igkgotkmqflrnuts	gnlooonqtpitijsp
igkggtjmqflrruts	ljrkutolkmlokrhm
isismlufklltgrio	lnkjopimhmiongjg
isisultfklltkrio	uofjrhmhnfjqtsou
fihqokpfhnnrmrnm	uofujqlgsjfhnljf
fihqgkqfhnnrirnm	rrstsoglkrspkmnr
jhmuojpokjgkiijf	roonqtjngsflusrm
jhmugjqokjgkmijf	ignnthhiqrrrrurn
psgjmoifjmqogrgh	unlkojgqmmqgtofn
psgjuohfjmqokrgh	lnkgpjmlnkufkppt
mhjomgrltomnffks	unghmrtugsotpulg
mhjougsltomnjfks	gjhnijihfrmktnsr
ptqhkonrqmtmnjjl	klfihornrglioign
ptqhsoorqmtmrjjl	rhupotoqmofnksfk
qromhikrtipmtouj	iofuffsjjkujgoqt
qrompijrtipmpouj	lnmrrmuhnqiosnuj
usimrgssounrnkff	rkiuuimurupltrif
usimjgrsounrrkff	jfrhqulokfhrqoju
jfroogumtlfflolu	srqgrtunskmkmrfs
jfroggtmtlffholu	himtlrrqjniummsh
mnthmqjomlfrqrnh	kjttfijfpqtlffkr
mnthuqkomlfrurnh	tkorujunirgouljq
qpumqlkljklgpfmp	mmtmiqgslompqoqq
qpumiljljklgtfmp	uhpkukhphifgstnm
fggkgigtskhoqqqh	umfnmotkrqmuipqf
fggkoiftskhouqqh	rpltkmmnoqphliuf
rsqjsoihpqppfimt	jlkrmmnlphthsjif
rsqjkohhpqppjimt	rnuhulossltpinml
mhokqfgulhsnkhgf	ulntlouokipihtql
mhokiffulhsnghgf	toiosolokgrnqruk
mtkstkqkutkituuk	srsfhkiuprtotphf
mtkslkpkutkipuuk	gmfmgpujgthhulqk
hhingprhtkrjkjjg	lultnjsqipnmhnpl
hhinopshtkrjgjjg	qikjklpstlpomjms
uqtkoghlsjtiquqo	nqpmslpmuqhjhmqq
uqtkggilsjtiuuqo	nuqnhsoumgpiklgg
kqkhlgqkrluiglmn	lritkgjpnpiipfks
kqkhtgpkrluiklmn	rkfugnnhurhnuous
rqsulfliptogqhss	ruqqukrgigjrlonm
rqsutfmiptoguhss	gpirglptjotulmuf
psmjjnjlhgskqghq	mhnqrgslgfmqgfjj
psmjrnklhgskughq	sotsgoritnmhoqjm
kftglongqguigrsu	ijqnokrgsupiqjrs
kftgtoogqguikrsu	gqkrnthjlqisihgq
jntflslsgghlhjot	mtpiiphlfmtqjhnq
jntftsmsgghlljot	lioomfhrhifttnjr
mntrhusttomfrsqu	oighfmpihlnohqhp
mntrpurttomfnsqu	utsorurmuufrjrjh
snlhliurkqsusnsg	fgmtrmhinfgpkgmi
snlhtitrkqsuonsg	fkpnpqosnfqusjjp
