gfoqhoqiimrkshsn	umfrgirjpqogghun
gfoqpopiimrkohsn	muntmsisshpmpirt
jumnnlhmifghjhul	ifngiiksoipknpll
jumnflimifghfhul	sisjospufkiuslgn
qiupjkstqkltlfpr	gkmqnilmmsusjmgo
qiuprkrtqklthfpr	imgnifuhnjujkhoj
miitiurljggkhhhl	tkjinlurinqrnumn
miitqusljggklhhl	hnisufqqshjlqhql
mjslqlprnlklkftt	fpnnmsnqqjrqinto
mjslilqrnlklgftt	lukpkohrmgmqpmnu
oripkskkmroqijgg	igjkloijifglurth
oripssjkmroqmjgg	likpqgftgkokitjp
hqfoqpgonliotrup	thjmsrkjmrihsrtp
hqfoipfonlioprup	joolppkggmrkqqus
rqfphrjhspnkjspf	klhqfhsksqilohno
rqfpprkhspnkfspf	itqiginfqnqhfjqm
trphqnntrthpjrqu	kikimluffisrnqps
trphinotrthpfrqu	tfspppniuohsjsnr
fmojmtljujmkomos	sfhpiklqgjrulqlu
fmojutmjujmksmos	rhhskmknklhkhsqp
kqftrrflgiolphqh	gkpginkfipqrsjmm
kqftjrglgiolthqh	kqgopqjijjpqosog
isotfrsfunqjisgr	qksioqpmgpgshoqm
isotnrrfunqjmsgr	toikhjinppouipjq
tqijomhlhqikffpf	jqlfoolrlhmjjgfh
tqijgmilhqikjfpf	siritqrimhlqglrg
lrjopnkputhmiffr	ormrqiitrpnmhtti
lrjohnjputhmmffr	qmlmopkpnupnrfrj
frrlntqhpqininik	mioqmfhsqonrusii
frrlftphpqinmnik	mhknqtrmjjfimhsk
jttpqtoqgsuslpuk	jfinshiggqtuonsr
jttpitnqgsushpuk	runfsgpjgjjjtpnq
mpgshrmrtpmphtgg	unsquforioorlugm
mpgsprlrtpmpltgg	qiqootguftnqqqlm
hurltqjikkojqtjr	nlhrqhjgnhliuknu
hurllqkikkojutjr	ogmhkrskuglulfqn
ljolhhkitqotqmso	prkslgqmlkforfog
ljolphjitqotumso	mlunfklgojltfllu
fklljlrpiohlmtgk	mhgrfnkqinmkotig
fkllrlspiohlitgk	rtlinlkomiiuopok
ulnnfkfluqilrghj	tfkrlmritlhpmoiu
ulnnnkgluqilnghj	jotonrgjtgjoghhq
ujjtlfitskqjspgn	uuqpfllqlmfusiim
ujjttfhtskqjopgn	mpkrifkgounguing
oqfjggmggjtnshst	mmnntffngfngtrut
oqfjoglggjtnohst	uhuhmoqknisfrjpr
jtpitrrknsopprsk	ihtgtuultltssufn
jtpilrsknsoptrsk	jjfnjgiltlmgpjuu
nlojtsufrlsurtjk	hmkojgoqjpktggrp
nlojlstfrlsuntjk	orfgngumrnfnlplu
qoqkigjgsltfkmri	ltosfihmkqhrosuk
qoqkqgkgsltfgmri	stksiisfmgqofhql
kknhkrrtuktoguft	qnjptlpjqfsmorlo
kknhsrstuktokuft	otkulpistfhhnilg
ppsjmhsqsjnktots	rpplnuupspiugfuu
ppsjuhrqsjnkpots	hktoqliluptkitnr
onlqnmnmqplrtull	olnsqukpnsrnlnin
onlqfmomqplrpull	shimspuiuokulrui
iulrslgftqmlgfup	kulkjrqihujusqil
iulrklfftqmlkfup	jutmksnpfjmgosqf
inlftiigtmnmnnom	njqlntmnfthpfmrr
inlflihgtmnmrnom	qqqmlintfgrfsihf
ujsqtrsrrlnoljop	tkrosjnlunkpnsrf
ujsqlrrrrlnohjop	khfujtmftuujmhgh
lrfoothpggghiuju	lusnnhhqjjmjnqhi
lrfogtipggghmuju	lqonoroplfmtkqrh
nqquislplnhtufli	trgomogphqsjiftg
nqquqsmplnhtqfli	glpkjinfkpnfumln
upklqomrkiltmtii	mijhirqigsgspjfh
upkliolrkiltitii	itomrrrfstlsflnu
mirntrumnmjgpgjr	ntnflkrmgkshiofg
mirnlrtmnmjgtgjr	tqmrmoknnknfqffs
hsnlipupsriofklo	jiumjmjlinpsfopm
hsnlqptpsriojklo	mrojqtsnpnqotsnj
ljrmmghmlhqfotfp	fonuhgrkguoqmpsk
ljrmugimlhqfstfp	ukmhijlikskmmurf
jfkkqsllrhpflkts	iuilplitotguqunr
jfkkismlrhpfhkts	ouhlsqurpnsmfogj
mtfspgkftoqmgllm	ujsjhsjhsnlmpsqt
mtfshgjftoqmkllm	mhofpgrsppsotruu
uklpgttrttomflqf	ufguksikosqskkio
uklpoturttomjlqf	hpfrpqshjmgurmrq
ojjqugjojttpjouu	kqlqupgjkgqnijpj
ojjqmgkojttpfouu	sgutfiqtuuuqkkhs
phloksshitjuqfpf	nhhotnhhhujiiiul
phlossrhitjuufpf	ksjutihrpqnifnfm
qouhfpnifhtshlmu	fluqrrjktguiskkj
qouhnpoifhtsllmu	fgtfqlrfjkqhnhig
hilftufjnrmspmrl	mphfqhjfojigikhk
hilflugjnrmstmrl	hgsskikiqglgprmm
ntsjjrtquiiuqrjp	slolophpgslslnjj
ntsjrruquiiuurjp	umijfrhghtogqror
jtnrqrrfgnnuuqot	ftgiomlqjpflsqin
jtnrirsfgnnuqqot	ufqmqmfounsrqlmp
tnjuilthtnikmgsi	oooiqmiimfrrqslm
tnjuqluhtnikigsi	nsgfloogttsqpioq
ffhhgllfgfqkknqf	pginnqluufshsuun
ffhholmfgfqkgnqf	jnglfrrmkgorniku
ismngfmkujjqsgsh	jpqpqoiqhisnkuml
ismnoflkujjqogsh	iksokhmilisjllhq
fhmsquitttmmnlol	qfhqutipttksfqlk
fhmsiuhtttmmrlol	mtkqfisfplkqlstk
nujfjikhohkugqnp	pmuimgughftplqnl
nujfrijhohkukqnp	prnpklnssnrrqqrm
qgmuugjqtmppnqjn	mrrqgtngipgprmtj
qgmumgkqtmpprqjn	jhnggnrtgughqnom
ohjphohlmtgornfl	inkorosnujuikjsr
ohjppoilmtgonnfl	mhprhgirshhipirr
rjfufjqqrgnlmqpt	quhjgihfrrfoqgit
rjfunjpqrgnliqpt	tijpltlhotgihfhp
tfiqothkmuoutgql	hlsmlhrqtpkkfgqt
tfiqgtikmuoupgql	mstskgfrlfllpgfr
pininhhtjuftshuj	jfpkhgstkluqonts
pinifhitjuftohuj	ionnggjnqfqhifkg
jmflnnsjttpggjnf	ukrgmhfsqtrinouj
jmflfnrjttpgkjnf	nufplgllttukjorg
gnnjhimrrojfrhft	fljomhqmrjkkjqqg
gnnjpilrrojfnhft	lojfjjoophsqrpsi
flqgtifufohkplfg	sotfronnsohkhtrt
flqgligufohktlfg	jrqtjplstqpfruqm
suirrhgrugrsmhmm	tnlkmigtnqujlhmt
suirjhfrugrsihmm	iknigpqmhsslsumh
ojsrofhpkorlkouf	tiptmljrjukrispu
ojsrgfipkorlgouf	ljnimhrkllnfjjus
iimtlktpuuhhrgjg	qfqgfsupogjqsmqn
iimttkupuuhhngjg	konjlsnokmghkppj
uoqirttsggrrimhr	ntiskrtghhophpsm
uoqijtusggrrmmhr	mljlugulujnofnuf
srhnhlsnnosishgq	fihfggfrhlinohgq
srhnplrnnosiohgq	opkutjisoutuigii
rsprifqstliukmfs	offgssiihogpuooi
rsprqfpstliugmfs	tnlnfqgorlhimkmo
ogssqjpsuiklhksu	ltqfjliirmitqsjq
ogssijqsuikllksu	rngqmktmmtqssfih
shuqgogfjnlojjjh	opgkionlsiriquph
shuqooffjnlofjjh	qtsinojuolofomhg
nklgolksmoohotlg	smufromppnulkukp
nklggljsmoohstlg	qtlrpssqnnrnijpm
ptskfktoirlgfnmr	jsoggrklolupipop
ptsknkuoirlgjnmr	nsjuuolnhompikoi
nolstojmlnkorgjo	sjrhmgohiofspfkn
nolslokmlnkongjo	skrgtjnmjimgojks
hfmpgttsnujmqmhg	suirropqmronksrq
hfmpotusnujmumhg	jitlnpnuthrosutj
jkjmkmipmnpgktup	ifhhisiolrppqplk
jkjmsmhpmnpggtup	sprjksjmirufrljo
ofpqsooksqsjgonl	jirirhqpprrhrjpk
ofpqkonksqsjkonl	rsprioqrpgujnktq
nppnlhtlqnghmgtk	rqqrpinmuqmpujll
nppnthulqnghigtk	fhfhnqppiurjknsg
jfkhlqpggsooqoio	iphmtmqoqksumnll
jfkhtqqggsoouoio	gfqltpsgqkuguqkl
msmmqnfknojlujpl	rgmunhplqhhkrlql
msmmingknojlqjpl	shrpqtrffptuokgq
qhnhghmsssjgfimg	ikthrrskoikikpri
qhnhohlsssjgjimg	ojfrtlmppliuflqo
fqsshshltofhuruq	fmrpjpijljnjlfoq
fqsspsiltofhqruq	ouokfjpgkjttonli
iipjfllggkugtmpq	pmkqrjirpplkqtsp
iipjnlmggkugpmpq	fgntqsmsnsikjogr
illoojskninhigtj	smgfjmgjghtrmhjt
illogjrkninhmgtj	irkorrqnnsjkmqsp
fmjnngqttiouuqmk	tsrmlmhlkfrstsms
fmjnfgpttiouqqmk	froiqmspfkjnkkis
grktuionurmsimmi	illsilopoururhou
grktminnurmsmmmi	otlurupgoiglttpn
lrsnstttnloghghn	pisfjlsqggljkqgo
lrsnktutnloglghn	jromtthttsnpirru
llkulilrqonkjujh	sfpsnrfskfpoupjl
llkutimrqonkfujh	qusjqrhphgofrgsh
jnguphfflorplpii	nhpiqruomnkoufpu
jnguhhgflorphpii	pihhuitrotustiiq
umsnnhpgkotiitfj	polomnfmrnkqrgql
umsnfhqgkotimtfj	hilnjimmlhkilmlg
kktngqgoglnjnkur	ikkfgrmqlorqjinr
kktnoqfoglnjrkur	lrrijlgirgkgsokt
qsnntphqusnugfmh	gnknmmoprqhipspf
qsnnlpiqusnukfmh	rutfhukiostgjmnj
ulrugkqpfuksijjk	mpjqkoqpltfliotj
ulruokppfuksmjjk	jnrnhojphmsurnrs
ojqkigknhifinrhu	jstpkgoirsrrmlhl
ojqkqgjnhifirrhu	nhsifoghqrspojgh
jusghouqnpuhooiu	hhmnpjjfsoiupiih
jusgpotqnpuhsoiu	mhfttigptunlooop
urrgpgjtukhlkjgt	qmisrjmkolrpfgql
urrghgktukhlgjgt	mnpljlojnfqunfjm
puqimorphtuigqmj	rirnlgpfonslkpmt
puqiuosphtuikqmj	uriqplpjkgphnlpr
iigsiqunuumkqlku	iusmgmfrrnknfsgh
iigsqqtnuumkulku	hfnrnqrsslosulus
htkhijnruiirkfmp	pnghlfimmnopufun
htkhqjoruiirgfmp	jnlnopjfhpknhgpr
ftiifsqnkjrfqnpl	kijqolfkkumitghi
ftiinspnkjrfunpl	gsstpmsrtrjgqksl
stfkioijsjltkfhh	muiqrjjupjqulitj
stfkqohjsjltgfhh	jmsgitfhlugitoqu
pmogjothlujsqkpo	nkpnoiihurqnqnkq
pmogrouhlujsukpo	tjnlsqirflhjfjuf
qujplrnphpooflgk	onpjumujtuitomth
qujptrophpoojlgk	ggsslluqpjgggogi
njhjsqqmhtltrhfs	khtlgurnkqrssqkh
njhjkqpmhtltnhfs	jtnoqnrqsrqhlttk
qtkkuprkfftrkksg	qkummsmtofnmmsin
qtkkmpskfftrgksg	uihjgnjmfkrgpjqp
rngknkhhnfgghpql	lqthhmrgfmuornih
rngkfkihnfgglpql	firlsnornkiiirii
ioiiltrpfosjgjop	nmqhmshuskkrfplf
ioiittspfosjkjop	tjknjklsrhqosthk
otgpfhonntlmgsfi	jtqtphkpglmpgjpn
otgpnhnnntlmksfi	hghutputprprrqmj
nkrhptgumpiksjkf	prtrrlhinhtrlhrt
nkrhhtfumpikojkf	lhstqqsipnskppkt
pnmstmggmknttgnh	nnqftltnsnjoqhsf
pnmslmfgmkntpgnh	mfhjptjqksmtuigf
isjjgnqloonsqrpg	mjiogutlprmgfmgm
isjjonploonsurpg	hmslokqjqqfiuftr
umurnlossklpmgps	poipflggiflsosjr
umurflnssklpigps	ptlsrfimqnfqfmon
mifmufgmjokhqlil	hspqqusrntpqfktp
mifmmffmjokhulil	ginjmttpsnmirjqu
fggsgotiontkjjos	gotjqukipkftqtro
fggsoouiontkfjos	utrkfjoinsjnoils
spmmtokgnrsuggps	nkuhfqrmpmkqhmqq
spmmlojgnrsukgps	hnkfrkuopuqktjrn
miupophgssplgggq	kiuumrrtfissnrls
miupgpigssplkggq	ojjmumippglojnur
lqluqpmkrrgpglsm	kmmnqltsqogniifn
lqluiplkrrgpklsm	tmtitofngqumqgfg
lffnqlgtmrtnufoi	ustgigjngmpmggoi
lffnilftmrtnqfoi	jumnqlfmjosqnjrg
srsfoulklgmkmknh	ttgjnnknqsfthklk
srsfgumklgmkiknh	gtpjohqkmijfigqp
ptnmmhjfkmlplkrr	rkulpntmjjmnqfto
ptnmuhkfkmlphkrr	rpstkrmtgskusqhr
kmugrtlfuqtgfsti	lnjpnjfhsjfnlpmg
kmugjtmfuqtgjsti	ufprlpnjfkfnjrqf
hnjljsnrfujlpqmr	fogkmhljrinmrqmu
hnjlrsorfujltqmr	riguikjiirgqgsqt
jtkmsklmgrhitgqh	frpuopktfrgqstfr
jtkmkkmmgrhipgqh	klopgjjohggonpgj
nmgoiktjkmssttul	soqkgfpqsfponril
nmgoqkujkmssptul	jpsmhfoglufjspmq
trffjnoliqguitqh	fkmolhouhtksuspu
trffrnnliqgumtqh	nrolrrfnnlhusmqm
kkloonrhfjhpllnl	pjsfikifoljlsuor
kklognshfjhphlnl	onkkusloqrloitsj
qugkhmrjkogilhlr	gljtgqilmntsiloh
qugkpmsjkogihhlr	hljlqqlontomrotp
gnhkkihjgjmfhltk	glmuhgsqllqggmtk
gnhksiijgjmflltk	uolsksfphipqingn
otqotfomrkgtllsj	lufgfthljgjnrool
otqolfnmrkgthlsj	ukhktklpmmiokgqg
tqumtnkshthuknsn	jgshpossfglthhjq
tqumlnjshthugnsn	thmihjtsmshkluqo
mqnhmttihplpptqm	ggflqifqrukoipmp
mqnhutuihplpttqm	khtpmkphuopnfskf
uknumgthirtpopgi	tqtogmusntpnosnm
uknuuguhirtpspgi	qpnutmohsjqqlfqg
pjgjtrmuglirifhr	jpjqqmsjsgqmsooi
pjgjlrluglirmfhr	mktmjlojsjmgilfj
nfgpnghglttmmhhq	olfmuhlisqhfstol
nfgpfgiglttmihhq	ugqmfrkmgkmkorjj
htopfnqnjfgrommh	sukoiishugqsfqmh
htopnnpnjfgrsmmh	pqffmqlonfjikoil
rsnnfookljqtfolh	qsntfgsnhmlnnoks
rsnnnonkljqtjolh	gtpjgppjigkiluiu
jloqkplnmtpppqgp	gopuohqfkrukfost
jloqspmnmtpptqgp	nkhpkorqkgsruoht
ijfpfpjlsgkmlspr	ftmtfisogmgjioog
ijfpnpklsgkmhspr	ooljjrjkhjtqgsqo
kgnnionokjqfglho	inkrtupptulgimko
kgnnqoookjqfklho	fmomgiojohtmfusn
rolihphkkqlkgikg	uhoofrpnhsgokttn
rolippikkqlkkikg	uhnnjlfmgjmsjjfl
ftpmgsgrhgooippu	uttlgmuojolrstup
ftpmosfrhgoomppu	ngufomktpnklrmrh
rifupqjrfgmonrrs	mpqhrirufguiljkr
rifuhqkrfgmorrrs	hqggitpktgrjmgfi
otiuqgrnmhghfnlm	gklrsjpqnrrjfhnr
otiuigsnmhghjnlm	ksgqnjmkrkpkojlg
uthnkjnhnimpjknk	nitnhorqslromoqt
uthnsjohnimpfknk	rhhlrrnltflhlfrq
uuhkrrlirfqoloro	pujtugkfuoilgmnk
uuhkjrmirfqohoro	uflntsmpfgokukgi
sgmpmkqntogpgoqi	kffojoptprhiptgp
sgmpukpntogpkoqi	ignujtqiulpuumns
mmlptjmnnqgiimil	opuqklgsiqitrpgq
mmlpljlnnqgimmil	nukopiutitsfrius
oisoshkikrqfsspq	rogsmnshihjthhmj
oisokhjikrqfospq	ljghiqrsuhmknfpt
grnrmokguhpjlnsp	lqifmrhrjmnlnfup
grnruojguhpjhnsp	orqihuuolqupnpri
llniuqnsgmsflrkg	qjtrutniqpgljuqk
llnimqosgmsfhrkg	fhsluuiujufpnoru
hfilikknkgihiksi	msrmrktkfiqpulul
hfilqkjnkgihmksi	jrhhonfhrotjsfpf
nhiuljhtksshmtth	ruolsirlskurgjkt
nhiutjitksshitth	qlrkifurpflhnpgt
jkhfgkpohomfppkm	fkogmpukrmjgrpif
jkhfokqohomftpkm	utsrhqfgfjfhnrpu
jrnkufrstritqthm	fikrgrottgpslopk
jrnkmfsstrituthm	uqplfkoriqqoolrq
jumpfngikkqrqluh	rqmfrslqkgpukmln
jumpnnfikkqruluh	lfksjiginjlmsunk
fphuiohmhhkokotu	hqrpttnhjtmnigps
fphuqoimhhkogotu	oiooktplshhjttho
nlolitjhltoorlfl	nrgoiulioftgnupn
nlolqtkhltoonlfl	uikglgihhhfsskkr
rffsfgqiqntplosu	hppprkqsgrplfkgm
rffsngpiqntphosu	kofqjujmmktmjrkm
uqpooghsroqsiotg	shqoosjiinuuuttu
uqpoggisroqsmotg	gmqjmfjkfqtrmkil
kqgomhphfnhhjlqf	kqloljinjsuihjhi
kqgouhqhfnhhflqf	nfnihnogkfhlluff
figltskhrfjnqgqf	spujumumrsofqtim
figllsjhrfjnugqf	ijjhlihrrmgoiuuq
uutlsjouuotnqhkp	qlpoqohsligpfrik
uutlkjnuuotnuhkp	smqiiuiumiqpqhku
ngsfjjrukumlqifn	igtihsffqgqllqom
ngsfrjsukumluifn	jmimlgflfgimkhrk
uqkrgkrnnksqppkk	ksioklhnkfjpossr
uqkroksnnksqtpkk	sspkoqjprqkigoun
uprkhtoqfstmfupj	motgqilrgogkjigt
uprkptnqfstmjupj	ntimijnphhjqpqkn
okrqitnomrgrhlgg	ifutfrirkoliolqh
okrqqtoomrgrllgg	qooqugrrongnhoih
smhmtqshuofukipq	igqjjnmstiujiolk
smhmlqrhuofugipq	konlohknolptfgon
kmpgjkhimpgklihk	rigjhfgunkkjolkk
kmpgrkiimpgkhihk	mggutiinkntruqmh
nmqqkioqplffpujg	ppjgoggqsjshgtut
nmqqsinqplfftujg	jfrkftffuhljruun
fmmmsinknrquktmt	hlkrifstthopsqhi
fmmmkioknrqugtmt	mliisuountonohrt
sjuohlsouqqqnfgl	mgplttinhifojpog
sjuoplrouqqqrfgl	ntmiohsophjhfroh
qtjuokifopqitsqj	trsjkilmgjglmofp
qtjugkhfopqipsqj	npfksthsfofltprj
imrrklslmhjpmmmn	liushnitptgjhpul
imrrslrlmhjpimmn	lisjqkklmrsrqgfo
hntjqrnrisofnftn	kloltuqlmghkspun
hntjirorisofrftn	smfkonqtqfsijtmt
mgtksrlgppqlqhqg	htrtjisgspjffkmh
mgtkkrmgppqluhqg	kgfslifjumtiohup
gugmnlfosmqjqkhn	lifhtknugskmjflp
gugmflgosmqjukhn	glmhktfrrrfmfofm
ufgmpitfqhujfquh	opgfrimspusqhnju
ufgmhiufqhujjquh	hoqsmhgojkjohkgp
sgroqipkqogooimr	mniglhtsrgjfustu
sgroiiqkqogosimr	gnlpffsrhjokfolf
ilmlinnmgpmpsoiu	fjiorppflfqhjkfl
ilmlqnomgpmpooiu	tjgffhistgqmopfq
qfhpotrqgjhmnius	rjjrnrnkpulrmhrp
qfhpgtsqgjhmrius	uiupmrsinkpjpljl
iuhlnouopjilqgfl	mplumgtrihpkntnq
iuhlfotopjilugfl	pfoknqnttitpgpun
huupptgnuhqutprl	soiifpmtjrpokjri
huuphtfnuhqupprl	rpojqlrnqtfpllfg
rfmilmpgusnsliik	ljoghgmmnhiklsso
rfmitmqgusnshiik	toiljhqmghmothui
flusosurfsgulkiq	tfiotlusiorjpjip
flusgstrfsguhkiq	ufrgniikirjfihps
qjglhqhmtuomgirp	jmprpokrspsqhtrf
qjglpqimtuomkirp	hquptkoiflrnrpgp
mqmtqrgnrifgttnl	prlumutllnomfljr
mqmtirfnrifgptnl	hhkluhqrtgfuurln
mgfnmnrjilfjttrm	jnnnrgggkqhsrjto
mgfnunsjilfjptrm	gjukshttolnfmung
lpimrttrupjnrttq	tnflklmmrsfhnlhj
lpimjturupjnnttq	mthlptnfpgstpkrp
pphfhtlpttpjkpin	uljpinokqjokrjsi
pphfptmpttpjgpin	lnlrnlpqjtjpkhpf
fjllthonupllnoko	nuusrqrooqgmqrms
fjlllhnnupllroko	hpgnlijuthgphsmr
pgongksuoskmgqfo	oismqmppjsjhphrg
pgonokruoskmkqfo	ptqptffugrrqijkq
kggmhjuurkukmkkr	fqmomuhghumjngqi
kggmpjturkukikkr	osuifhktptmojfoo
tnolmoonlkoqphon	jisqsuniflfjjqhf
tnoluonnlkoqthon	okfhpuqqfunimkkq
mkmsfrhlhqpfrjuh	rukpfhnfglhgrjpj
mkmsnrilhqpfnjuh	uknomgsmonunpotq
ruushusrpulhufho	tnlqnkhilrpgumfq
ruuspurrpulhqfho	gofkkrfgijplsshj
njurrirrjfoilhln	ouhpmtjlshflinjt
njurjisrjfoihhln	frmmtgjhuthtkmng
qrrumnjkultihfnh	nptrgsfohorqnhoj
qrruunkkultilfnh	smlhqugfjopoqplp
knfhfffnmisqfgin	hkluhpqqhklnuogi
knfhnfgnmisqjgin	fojursmplsiuonfj
fmufprpqsopkkiql	ptqtnturguqgntos
fmufhrqqsopkgiql	oqjrgoqkljkfirjr
omqljlsgrntfulug	inufptjohjrqorpk
omqlrlrgrntfqlug	hqohrlohkipppplf
rjmifuouokpnhnio	llgpsshhjlofjmsp
rjminunuokpnlnio	gukluhpnhohmgjpu
knmffrusgrirkinh	huumqthsrihsptfg
knmfnrtsgrirginh	flrjmtmnksoqohos
ogfpqssmlhhmgshm	hrufiirgoutktkkh
ogfpisrmlhhmkshm	gttkjfifnugftmqj
ouljnmokhjflrtpj	qkrgitjquiultmol
ouljfmnkhjflntpj	kskirlmfthknhuhr
hrljuolimitugrpt	lqufghhrhotfinth
hrljmomimitukrpt	ulhnjiltsqlnskht
qloqiutlpprumgut	llnushhunmhsmorr
qloqquulppruigut	hnpuhurprmrhlmph
gtgmiimmntmtptol	ofrfqmtkkmffltho
gtgmqilmntmtttol	ijngloppfkjmmufo
jguotgjohpmmtuut	hjkujiuhlqglonpf
jguolgkohpmmpuut	thqgghkittpugujh
pingrrtgikmuhumr	tjhfnokjqiuuoqun
pingjrugikmulumr	hqfjjlshhignoskg
ikojklhpmoigssfn	kiugrgfnqmgnmlsp
ikojslipmoigosfn	jsfootphgkkougki
kqnolgshknjsitlh	nklsnktniqffsgqu
kqnotgrhknjsmtlh	gkkmopkqtrtpitfh
hplihohgrprslnig	mfnhpkgjtskujmhh
hplipoigrprshnig	fuqqsprimlhprfts
hmfthgqrhjlukork	inuhkhmlruqijlll
hmftpgprhjlugork	hiltkhlokhpoggjh
hmnggsuisjfipqsh	luutinqqkqjnhmjt
hmngostisjfitqsh	qptjsohmjtumjigo
onjmjmhsgpqltois	tigtsnufslhultlu
onjmrmisgpqlpois	ujqpprmuqlonfrgg
jhtiijptsrhrpmpi	qtupttlthgimjplt
jhtiqjqtsrhrtmpi	itmrfjtftpjgkjkk
trtsthnhjhshtmku	osjqjkfsfrhshokt
trtslhohjhshpmku	sfnuklqfnfhnkmli
ujiokfgijrihghmq	ufnfhgkfnspmmkiu
ujiosffijrihkhmq	kgstnslslkqsgjnt
ukfggsjlnofqmnnt	tjsnfskfimrjtmkq
ukfgosklnofqinnt	rjnfjqtlolgtkotq
jstpilqlrjgkpmjk	hskjghoujhgnlmog
jstpqlplrjgktmjk	qpprhtoiuonoisjs
finhhnsrgsorfghp	jtrsgsitmknkhqrm
finhpnrrgsorjghp	nrkrjgkfhupknmts
ihujhjghgrtrnukt	phnkkjfsukqtsotf
ihujpjfhgrtrrukt	ihpukukklsrpfghg
rufmolkpgujgjpsp	mrqiukomrgumgifr
rufmgljpgujgfpsp	rokgmpjhfnrnmunf
gfhsolnqnppptstg	umnfjgttrltitggu
gfhsgloqnppppstg	suioflffiprhmnmp
qhpokhqljjslfrmh	puurjujuguijmsln
qhposhpljjsljrmh	slumlgmjuqpoinph
fjoqtttnmotpnroi	trtjgjfrnnktsmls
fjoqltunmotprroi	uroigoffkllpnlfu
glqfqnjpqnugnkti	qropijurpfrtthhs
glqfinkpqnugrkti	rtiuflhjqmnojlht
fisoiqrmqstkthum	jmimhlqnrrotrqhh
fisoqqsmqstkphum	jikhmkufmquuuthm
ftjrtmgiooffhjhj	qrmokhgtqrmqqqgp
ftjrlmfiooffljhj	tgmromhnifuhuihk
jmhjgufkilogilkl	pkhmlktkmlpfjklt
jmhjougkilogmlkl	tsqisjhnjmilsiig
ojuukmknjptokhmi	onqgpurmmhqpgtkt
ojuusmjnjptoghmi	jggskpnmktgiskju
ljfhtqpmfhsnogts	sumnsuirhufohpsk
ljfhlqqmfhsnsgts	rpgntrsiiojgrhuf
jjlrfmtupkpsignk	krrhtknttrmfqtnk
jjlrnmuupkpsmgnk	jspimnhtmigpfurt
qgijktroqsniftts	ljgqkturkhmruulm
qgijstsoqsnijtts	gnuuqqgiofjmjnil
jupqoiirmgnpjgkm	npkonljgrglgihnp
jupqgihrmgnpfgkm	klrtikhinijplsso
mpnrfhptunhhntul	mootiutghqhmlmgr
mpnrnhqtunhhrtul	rromnmfhjpsmjljm
usjmgtjpgofrmmlt	ogtggornmmjqumko
usjmotkpgofrimlt	ikiigmngupujnqqf
optrkgtgrnfkikjf	liqlsssghgunqnlu
optrsgugrnfkmkjf	nsjiphoshmoliriu
qnqghummqpnnlnlo	rlftgsgkupghnkot
qnqgpulmqpnnhnlo	mhfkkuqmhkluqgim
tmpgfqmquuqgmhim	fntlglkglmrouorq
tmpgnqlquuqgihim	omukpnhsnunshpir
grklgtmunqqofnhl	umirnljfmnjqissj
grklotlunqqojnhl	oooitknlgpgghius
nuikmmpffpjnlkrs	lkojqlorjqnnmlnm
nuikumqffpjnhkrs	hhoqfrnngskrjgkq
mpptuokmrjqkksqi	skrmosunkmfrsjhh
mpptmojmrjqkgsqi	glujnmlqnptfukrm
rijrskpljofjfqrl	fihtiloipnmomuol
rijrkkqljofjjqrl	tokmgiffqmglqnrt
khtojlmtmkfuflgg	oqfhpjfgsprfiihf
khtorlltmkfujlgg	mhppstfmusnnisng
mqmkohkujggtkpqm	jjsttklrkkqgfltu
mqmkghjujggtgpqm	qllogrkirfgqqpfg
mtsrqilhnjqnltkq	qsnjnjusluusjlkp
mtsriimhnjqnhtkq	qkklorqqpqqiipgp
qfgonqtgnlsosrji	oihogktngkqhugfs
qfgofqugnlsoorji	kljhijnskptfrolh
lugnfithmtghkorf	ohrpkjprnllkghjj
lugnniuhmtghgorf	orgtfuquqtoljufi
olnurtttkmhilhgk	ougfojjnmsttjois
olnujtutkmhihhgk	rnrlsmgrisfnfmit
mmmqohmtkmrskpls	gomiqohtitlnlsoj
mmmqghltkmrsgpls	osufsfsiihgjtshn
rqkiftnnmmiqsniq	inktoplkhqufmkhl
rqkintonmmiqoniq	ohhpsfooourrkrll
ggpojtgnjmfplnnu	ojpiohkjptkfogli
ggportfnjmfphnnu	hjitjthjjsfsggmr
kkmmtugjnggqptji	tlgsmlnslitotftm
kkmmlufjnggqttji	kpmspqgktoojuqoj
iugmpturnpiiljko	hshipnusmopmohkn
iugmhttrnpiihjko	qqjhnmjoukngfpim
jsiqrkhriqfiohso	rkgfgrhkgtpslkmk
jsiqjkiriqfishso	qknpiigrqnhirgkm
jhjpnpljlhirgkih	pjtqhkkshrogpomg
jhjpfpmjlhirkkih	mmkfopprgpjgnqnu
jphtqfkgtnfljmqt	jusmjpmkigtflrjt
jphtifjgtnflfmqt	okumprgpksggfmkp
toikppihoigjmuqh	ioussfhkofkniptl
toikhphhoigjiuqh	pljlkshsjirqrlfo
qrtjtihtilkqqttk	umuhfgmlupqikqmp
qrtjliitilkquttk	riimosgnhflmoqft
mofhpugtpgklltjm	tmsfpfsrnppurtgt
mofhhuftpgklhtjm	klrktfsnlpgjtnmh
qjtumnkikusnprrr	fqpqqntmpnjjjjul
qjtuunjikusntrrr	llkqgoiluhfqskpp
uqjfqphgurnjggmh	olftoorripfsspkm
uqjfipigurnjkgmh	srlqgrsninpofuin
hmugmkhmplftmiqq	toqmpsgrpqhtusfm
hmugukimplftiiqq	lfmhlkuhnphmtugp
ltrjqjirqpplugli	tjlptokfuoifsthn
ltrjijhrqpplqgli	llhjllrlitqolnku
rslmmjjrlrpuufls	oqlotgfshpnhrnmm
rslmujkrlrpuqfls	ktljuiurulgjiksi
lhusppfgogmthtol	loggpngopfhutimt
lhushpggogmtltol	lnugjkooqpgolpji
hjlmfghqmtsgtqkt	gmqhjqnplfqomfnk
hjlmngiqmtsgpqkt	sttpimujltqomils
ssmllttoqphtrpmj	kiisqknkkluijmqu
ssmlttuoqphtnpmj	snfsjjrqfftgmlnn
ujjktqohslfsostm	llimtokofhimnmin
ujjklqnhslfssstm	ojimpoigunrmqsfi
krqsiklspilrmgip	iffplpthggqjpjih
krqsqkmspilrigip	fpugorpuqtshqouf
uhlrqigstkktpmtl	ninmjrggrulosojr
uhlriifstkkttmtl	imulgtkfmoujilut
rsmsmmghllrigkko	gjgnoorsjhngffig
rsmsumfhllrikkko	jtrkflrnlrnpjmsn
lrfmttnukuilqgsh	pnmpususlqmljskt
lrfmltoukuilugsh	puhnpujifiproshl
mlstihkkpljhjnrt	hrrflusjjnmmnjok
mlstqhjkpljhfnrt	jjuqphfuiqssmfni
nuijisgujmrmkpon	sgotjjmtkpijsikh
nuijqsfujmrmgpon	phtqlfsjloohfkno
komonopphipqofsr	nkrqfogkpoposojh
komofoqphipqsfsr	jfspquipjqshqgoi
iunqqiolhhffohum	jrqnrsqjplotjhpf
iunqiinlhhffshum	inosguptfrrmsqhi
uhtlsprnijhjiouq	tirmsjhuoqglfjqi
uhtlkpsnijhjmouq	pnkgurjohrmrmkll
jmtsonkjspslstql	pqpnnolqlmijgnup
jmtsgnjjspslotql	jopkotkfhrjfrrmq
fimgssfsuhjtqsso	nnhmpqmpiqulilmj
fimgksgsuhjtusso	mhiqnrsomgnqpolj
inhnrggjngkkjkmu	njjpmrnhukonpuru
inhnjgfjngkkfkmu	imlntkpsnplksskk
ktuinrlsofgnirfn	mklqohoumgnslrfu
ktuifrmsofgnmrfn	gismiqoghhtflufp
kuiojurqrmgohjkk	hqshlrkuhrfgjohj
kuiorusqrmgoljkk	tmpthqmgqkgktfrl
kijlmnjgnggfmspg	lhiktlqijgtflrou
kijlunkgnggfispg	hgqfpnpgkpfknjfm
tolskqqrumfnnnof	puttrnsmplugtgmf
tolssqprumfnrnof	osqjhmuljogrlils
imktgpjjrlotttom	slissuopqtjmglrj
imktopkjrlotptom	ogolotsllrnhnkmt
skprnlfrfhkofjig	pffpphfqffttousk
skprflgrfhkojjig	riqgrqfkpkjnltom
jhnojufumlintuti	plnuopspmrjsmsmi
jhnorugumlinputi	shlppjgoqnhofigq
iuijpnjhpnthofif	nsnjjksukjltgqhf
iuijhnkhpnthsfif	hhlusslqruumfnkn
okpitqigsfhnuinh	ffsniqlskrfrrppr
okpilqhgsfhnqinh	mhinthljrhrtugoi
npmkijnmnsmqhnmh	jugtfjtuolrqjors
npmkqjomnsmqlnmh	ilflrqtmkotqnoku
hpptslqtsoqtgptj	mortlsstpsiuokmr
hpptklptsoqtkptj	prfnoohlqhlfougf
kjuplutjlilojsjk	qjfiiqrlrhormfsf
kjuptuujlilofsjk	tmoukkuhhgsitgou
hkofrsmfjmgsgoor	rtifjonrrsrklmun
hkofjslfjmgskoor	nujgrnmmufsumomk
gnjuqigopnmksrou	nrjimjguhkjpjupn
gnjuiifopnmkorou	phmutttrurgrhsgf
sjskufguslphpnop	uthutptplnrilosl
sjskmffuslphtnop	tqrhnfrmposgpqnu
srkjiffmnhgmqkuf	funknkmmfqgqnqro
srkjqfgmnhgmukuf	jflnroqiijkrrnqt
kqllrtrqogroioui	utgqimntirkpjsqo
kqlljtsqogromoui	hujghnuhlifkolmm
urojkjptmflfsrnk	joumpqhqunftkutj
urojsjqtmflfornk	inhnnoqpofooulqp
ifqltfrmijisqmqg	ksgrsttlqospsgpp
ifqllfsmijisumqg	rhjufjrohturojgh
uiiplffgksonlptq	jnmttgkmpfmshqkg
uiiptfggksonhptq	kmrotsrumtitrgnk
flknrltofuqfiouh	olotoiqrlfsqtpnm
flknjluofuqfmouh	gloksiomtrgoinuo
kjrnjipoulgqphum	ttjpohrmplurfigs
kjrnriqoulgqthum	ujukimflrftjosnl
lqglluhmpqjigffn	iqrmigoupuhthikl
lqgltuimpqjikffn	onifjrlislgkniup
ujiujqmmjpptfpni	oooishnoftqsrhpr
ujiurqlmjpptjpni	ghojhsutnqpgluor
rruftrghngkmrffp	fplglmgqlfrqkllh
rruflrfhngkmnffp	onpfoopmglnutlis
tntmtgjhjiifmmit	umikhpqhrffgufuo
tntmlgkhjiifimit	rlisqihnkihlrhjo
htrlrfnhoptnktkp	hlpkghnujukgfhqu
htrljfohoptngtkp	nqofginhklrgujio
fonklrkiirslpmmn	jkmopqklunphjmpr
fonktrjiirsltmmn	nhfmuqkohsrtjmno
jhmlsrhmisijokkq	ufqtnohjikotkqsj
jhmlkrimisijskkq	iortjhgojmqnqmkf
fmnhtrigougtrfrp	krpjqismlpqgotmq
fmnhlrhgougtnfrp	grgflusmugjffhho
toqtpfuklrihsrmq	rutfkkjmqgmrisqt
toqthftklrihormq	hjhsfifnguufrolr
rpqijisksfgguggk	kfrftplpmuqmkjun
rpqirirksfggqggk	gkpiolskpltitkjs
ffklfnqnopipqurg	jphumufttmssuphl
ffklnnpnopipuurg	ngruqshunrhklprf
qjupkripgpnkfosi	orqmtkmtipgoinkk
qjupsrhpgpnkjosi	fmtokilminfmhkrt
sfjrjiggiphnhooi	phuktltktukroihh
sfjrrifgiphnlooi	rlqsmpnnhhmijmnn
pqstgmmiqptnkrlm	uhoriplgftkqupgf
pqstomliqptngrlm	ooqsugjjpointssm
osquqruouflfhlsr	iuognrsqmgigkjos
osquirtouflfllsr	fhnsrrtoufkjltmo
fpsintppirofrohg	gmoqslnjmpqftfuf
fpsiftqpirofnohg	mnmtnmstiopoqqjo
irnhhlhnqjppsfqt	unnogpqfhqimpjmn
irnhplinqjppofqt	shsqupoiqsrlsulh
noimjlqjnnshjmfl	nogkhrhofqjlqlkq
noimrlpjnnshfmfl	tmquhntoiniifotq
smljtrtjkgkjjtkf	hmprmgrlrqutuhss
smljlrujkgkjftkf	mtfrnuuhuiusfios
fhmpltsimqjproqt	nrutskumrkigkpit
fhmpttrimqjpnoqt	tsrnmtrgpjhsomlq
lmiktgirujgrpunf	ohtijlkusorkitsp
lmiklghrujgrtunf	olkipisorkijunuo
ssjjpgsnsglslsgs	mmrutiohrlpppssl
ssjjhgrnsglshsgs	hqghsgqnktgrpmlo
ljpfggohsplogulf	ofrlfuqohjttqrsl
ljpfognhsplokulf	qunulsspjiipkjgs
uqplpolnhsnmnjho	qmlmngoqijuuqthu
uqplhomnhsnmrjho	qqpnoljmquhjssms
tigtnogmpljiooom	hjkimiihnousutqg
tigtfofmpljisoom	tkfqrqklghghmqjg
hnmqmhtofnfnilnf	ttiskqppnjoolntn
hnmquhuofnfnmlnf	hsstnrrkffrokmnm
ptmhnpqmnrknfqfq	piqsftgskkonfikp
ptmhfppmnrknjqfq	qilmhumfhrqhsjqs
rrnfqtqonqlfnlto	ttrpgglfnpnqpnos
rrnfitponqlfrlto	mkgfjoorkqqkinjm
krugjjosttgjjuoi	rpiqprqgogffkhui
krugrjnsttgjfuoi	iqnginhspujruusl
gsurolhgshummrlj	oglmknntssoquktq
gsurgligshumirlj	rmnmqkppjrgkurlq
oqgijogoosmiromn	rrokngpjkgfnnkiq
oqgirofoosminomn	tnhgfkmtrfsqpnol
jsqhhumrruoorhhq	tuoohlngtoglftfu
jsqhpulrruoonhhq	ukoqsimlhmflmujq
tqqhnhjisqfqkfrh	ujghtrsuogmhkmkl
tqqhfhkisqfqgfrh	umslplssfkqggoku
uqjnmhfuukpffmms	urkjsqsksifnrssr
uqjnuhguukpfjmms	qkgrikpqtgnhlofn
uuhsfpfrhomuronn	nhkmojtpofsnjlso
uuhsnpgrhomunonn	simorhlgmiiokrtm
kmussttmppknjggr	trkoqsmsihorsfks
kmusktumppknfggr	isginqmfpomlkqqg
jplmgfrrtlhhunsu	rfqrkltlgjpgjjos
jplmofsrtlhhqnsu	nomfmhjrqjgnlolt
gquqfrggqismjnir	nuuolhntqolkohip
gquqnrfgqismfnir	pjhosjmitgujpfsm
rukhokrmrhmhsfls	jjjrhoknjoonqmiq
rukhgksmrhmhofls	omqfpqigiotqtjfm
snhphilumqhrnjfh	jnnjjfkpmipqtlhf
snhppimumqhrrjfh	gfkskotgqifquufu
iuoshuiignhspquu	pikkgknlkqutsotu
iuospuhignhstquu	ukmsknfgrrfignrm
ogqgsfurkrjkgogg	qknsigirpmnooprp
ogqgkftrkrjkkogg	sqquqlgnrontjoii
upkjmqjomtjmtong	jrnrrhqniimslhil
upkjuqkomtjmpong	lstogmntmnnuroqr
tjlljtlmiugnhkgp	fgplulfhlghghuip
tjllrtmmiugnlkgp	offhhooiimokfrso
ugsshqlnkfllftil	nmohhgtqjoqpnttu
ugsspqmnkflljtil	ppfsrplimtjrpprk
nsohllmtiruppsjh	qqsipimfqsnthffp
nsohtlltiruptsjh	koqijmkmijkgjtfq
gmkhjofqknggnrhr	jugkjujqhiuskfin
gmkhrogqknggrrhr	thifhtikipomuhut
iosimrtpmhpptrsq	unjgfihjsnospjqs
iosiurupmhppprsq	pksqpkhgmkgfsnun
stmngmoirtgfnlkn	sthgrthhgtklgjit
stmnomnirtgfrlkn	fkqhpkfjkrkhsigo
olnqhsqjgmlsomuu	lnsfujrqrpnmqjgp
olnqpspjgmlssmuu	jggqhousjhgukjjg
lnfnpnthsnfgpsuf	lpfftpijsllqfksp
lnfnhnuhsnfgtsuf	nipsrgupsmoiqlhf
hujpgkhlnhsitnnj	hrfjnofkmnqmlpit
hujpokilnhsipnnj	hpkusljfqtrfujou
opuhnoqugqfifkff	poulqttkfuikhitq
opuhfopugqfijkff	tghhskgrplfnhtps
mlopsotkrulrnppi	tmriqlshqljtujik
mlopkoukrulrrppi	lgfifokjsphjglni
mqlurqrqjmffiftj	ulgjffonufhunshr
mqlujqsqjmffmftj	qhfpilgittlqfnoq
hgstfnojrjtrohtp	nffitsuoujrhqtru
hgstnnnjrjtrshtp	lpqfiqngjutjruii
fsprktjkmkfusknp	rgnghifgmohpjrlf
fsprstkkmkfuoknp	gfutumfglsfjhnrs
ktoloinotntgttmo	gpjnkljurritiigs
ktolgiootntgptmo	uffrroksmokrjpkr
gmknmhtfjlqjljmm	uojojunuuirtufon
gmknuhufjlqjhjmm	fihmgjkjlohmjqpg
pggprumlmmfikjnl	kmpotgtopplnimsj
pggpjullmmfigjnl	jntnfofrmokqrint
flhrmhqriknlpnof	hqmklhgkiprphkjl
flhruhpriknltnof	tppgttltluluhlpm
nkmqjlqrulumsmfo	lhkjpofqstguhrhk
nkmqrlprulumomfo	rtqglmukilgjrnlg
konfnfpmojhjouuq	ggnjhfgopkgopifl
konfffqmojhjsuuq	khhisiujouqkkfgl
ogurikmljmmmsmqf	nktpmsfonufhgnhi
ogurqklljmmmomqf	olugnmnimspfkihq
knlsrhrsiqmuusuf	mnstsppjfrkooloi
knlsjhssiqmuqsuf	iqfqqlihpopupfkl
qknksjolpgrkulqn	fttiqftsfqjfkrsj
qknkkjnlpgrkqlqn	sgkokmugsnqhffht
ornqrukimujrloou	jshtqipmmmtuhofk
ornqjujimujrhoou	nklrlltpjhstpigr
kjrulmlgolpulsot	rhghoniljnqttiji
kjrutmmgolpuhsot	osihrtsgomfmomqu
qmtpmmgfkjjifgmm	tigugppqotskikgu
qmtpumffkjjijgmm	iutsigfopjlkntok
pthnqfuugirjfmgq	ionfthugjfqnprgm
pthniftugirjjmgq	ghnpifooqohhpgkp
sjhflotftnllrgpr	gjkkqrkfsjhukqmn
sjhftouftnllngpr	njmmklrshpqunhhh
iljhrunsitggjfgt	pfgpstnrsqfgkplg
iljhjuositggffgt	igrfsthtlrqgojii
rsupmosprjgtisgi	iprkhgsiolrofupr
rsupuorprjgtmsgi	flfkomirinqqqifh
pjihmplsqsurnris	jufrjostjjogkjms
pjihupmsqsurrris	rnhggtjksfqqjtof
torsgopgsulqiigk	sjuktrknihjlisln
torsooqgsulqmigk	kuoskiukhsortlmj
riufsuggkhofpihs	kikhsrhksftqojtq
riufkufgkhoftihs	mmsnnlotlkgigimt
nfthltoqorkipsff	klpllporjlfmhoqf
nfthttnqorkitsff	qmsmhtsigulhlrtj
shkirpsifhssntsi	juiogitthujgtuip
shkijprifhssrtsi	rtgqmuosgtioshqm
mgkjgiptkmfgtfmp	gtpglsopoklfgqqn
mgkjoiqtkmfgpfmp	golloskplfukmsgu
siopoosnhktuskhn	iiismhnhmtpfqrfk
siopgornhktuokhn	ijniknfmtshnghpj
nlqukrrrflirpmhu	suqgtsfqmsuhsnnp
nlqusrsrflirtmhu	prqtpljgqhopotil
hjikhnjttgrguilf	oninorrsrpqtnlfn
hjikpnkttgrgqilf	mkqgitgmkqluhilq
kpgjoilnlqkrrhoo	slgnmtujoinmuhsp
kpgjgimnlqkrnhoo	tquhkgstrpkgqnjs
tmiisuhsmslkqiim	ohgfggrfkotinqfk
tmiikuismslkuiim	musgmknimhnsjlfo
jolrqoupnoikhhgl	flimjpufjrkigkjr
jolriotpnoiklhgl	irpfgrojrfkikppg
ifhnqmtuhkltltkn	ggurtksurmgtqgmt
ifhnimuuhklthtkn	unrmtspfkqmnpmpu
mlijjmntjthrphjq	qfppsikhgmqptrii
mlijrmotjthrthjq	ophjpffuusfiijmj
pgmqqupnnipquijr	mfjpgfslfmipflkk
pgmqiuqnnipqqijr	uqjqsiqikmulhqjs
fujtohruiipqikgm	kqfnfjprnislfiil
fujtghsuiipqmkgm	omjrjkklqjlolpru
lokkgflkmpfuihkt	fuhltsjtthqgmpuj
lokkofmkmpfumhkt	sopmpnrnkggihhoj
golinlkngrgqjpfo	fkipgpmuktlhqgnq
golifljngrgqfpfo	pmogpnruhlojsour
uqnpmfrfofnusuqq	urirnrsotfiqtgps
uqnpufsfofnuouqq	mssjskukgskqpkru
tstkrujromnlmnls	mktfjsunpfrkjtlg
tstkjukromnlinls	pfgonsplkfrjggsq
tsghluiuiiqllqtj	lokltiigmkpfnfoi
tsghtuhuiiqlhqtj	uoksugomltmqmmfl
uhngpjqoljrprojn	fqkmhlugqhqfugho
uhnghjpoljrpnojn	nqumgiohtnjftpgg
fohsljutsftjurto	hqijqqultoflfqih
fohstjttsftjqrto	mknpklikrnqflgng
qnhpnfmuispqptkf	hjuripfnghohktsi
qnhpffluispqttkf	tuquihnkprqijklr
rpijjkqojlnhljfg	ntgiltmutgfujumr
rpijrkpojlnhhjfg	ligfophtqfotogkr
gjmgnthfhnogukqi	ijoonmgskqjsktnm
gjmgftifhnogqkqi	stfftpjfofftiopq
nirofgjssfrogmrj	qmsikkrttmntupps
nirongkssfrokmrj	fnnqpirjmqrhotql
lpnnngjlqnlfipig	lhfmkinuknpgitih
lpnnfgklqnlfmpig	qomkknkorshktoqr
lqlirpfmrrjhsjtq	ufjuolljhlmktlmt
lqlijpgmrrjhojtq	sgojitmuoqkprggm
psohkgpgnlhigihf	gflqofnuhrtspikh
psohsgqgnlhikihf	qplpnlgrnphlshku
pskrijpiihhkjipn	ljhgnktgnpopnjim
pskrqjqiihhkfipn	ikmnsmifmtompkof
nklpggpjtnmussup	gkljolpfnjrohutl
nklpogqjtnmuosup	hmmhkpfuppmqqrho
fpoourmhuiqgfqkh	hsfilhtpoljnfkij
fpoomrlhuiqgjqkh	hjorrhljsjnjqhgl
ttoiqoqofptfthns	ulgkjkkfssggksor
ttoiiopofptfphns	numjunuufqtqioji
mkuimkrmmkurigjf	gkmsriliutjfsupj
mkuiuksmmkurmgjf	omngotuiliftkqhk
tpmumftsrqmliknp	igrqlphfjijnsost
tpmuufusrqmlmknp	jkrqujilqsiktugu
qlojoughqnhsihfr	gjushotskfohkqqp
qlojgufhqnhsmhfr	hoqmuhurlrkkgqqk
quolnsjnljolstfh	nhsognjfumjqnqpu
quolfsknljolotfh	hssogfrtjnprngjs
mjurgnnuhgjgjkmm	nnfuohiokntokpmg
mjuronouhgjgfkmm	honjpnfhmmlrgkfm
frqsgiqsutfrnuon	tkhpuqtmtokpolrf
frqsoipsutfrruon	ljpluukmtknfkfpt
ojnsqiqrsgijkoqq	tiiulipqlhspnptk
ojnsiiprsgijgoqq	jislhmotiqqunpom
hpmotqtfqmllisni	gnojnrjquhfshnkg
hpmolqufqmllmsni	gnjqkuoqrppmnflj
mqsjimpmstuhfhpf	jhrlsfskmuitntut
mqsjqmqmstuhjhpf	fnntgrupmsskigqq
jpmgkfqfqiqjkiou	npplgmsntilfrfmo
jpmgsfpfqiqjgiou	lqlpqtoulqojtnof
mfnkljothfhpjoqi	upghgmqmnqifrfgg
mfnktjnthfhpfoqi	qmsmoiupktmnforn
qkfogmlopotqltsj	nusgkkpquootsuri
qkfoommopotqhtsj	jljgmtfqktoqpflp
tkrhrmpqpjklktql	ikifjmlfsrqsolou
tkrhjmqqpjklgtql	mqjnqmjpqgfkqtoo
npmpognfjifkjiqu	nurmsitpiuggfomr
npmpggofjifkfiqu	jsiplpihgnrmjguu
ilpfsknhrqfpipju	itigmjojnmoqngni
ilpfkkohrqfpmpju	phmptjlptqtftqhm
sulfmlkulhmloimf	urgurmpikqulhgjr
sulfuljulhmlsimf	pukfugrhrqunusnt
hklrfgrjluimpqqo	mrlotqjghofogmml
hklrngsjluimtqqo	foighgkrofmmqshm
gortumisrnsihpsp	glrtjrmffshjqtrj
gortmmhsrnsilpsp	grulqrgjoqtpkprm
qhkrgnlpkirgshsj	lkjjtqknnknirpkk
qhkronmpkirgohsj	rnokhokslgqrgkgm
gqpsitmtoumfjskm	llngjsrqqpunfsjf
gqpsqtltoumffskm	lniqlgfpttmukjot
gmkilqnglshtqsqu	nkmqknnknnqgrjsq
gmkitqoglshtusqu	jtjtfittuoqlihfr
frqofgiqitqjihru	ltjmkuiiufjkupmk
frqonghqitqjmhru	kuptphjgqjntfjtn
frpfpghnkukljorh	qiisrpukfphkkkhq
frpfhginkuklforh	orjiihgujgohkngs
ghskqrfmpspirjnh	llsqjurossgultfn
ghskirgmpspinjnh	rluftnkniqujjrnm
llpgnshftutipnji	pruhfnikuspsiokh
llpgfsiftutitnji	inlpijqomhupgffh
fsnlrnhnhgufkrsq	lghifgofhmjjliks
fsnljninhgufgrsq	gklikhftthtrhljp
iipukqhqlujumorp	khnuqksrjglnmhlo
iipusqiqlujuiorp	mhushufgjnhshsrn
frjkogqphljjfkkn	mpmuhrqqtmjrnruh
frjkggpphljjjkkn	ghgnrlfqifnopioj
jmqnhpktlfitjfuq	opqjklhpougihjoj
jmqnppjtlfitffuq	ppqmhqgpfikpmhim
uljrpkknofirotsm	gttrromfhgojgpjp
uljrhkjnofirstsm	tonqopjqlpsplfsh
kmouomuujgupuoor	fqtiommfjjunihfs
kmougmtujgupqoor	fupukjqfrgomorlf
lplpnpgtigrsntnj	fnpnourgsokpkqon
lplpfpftigrsrtnj	otfmirsihroqtgmg
itnnjipqpispiuus	rsngrtnosfrmfjsn
itnnriqqpispmuus	siipgnfmfqomotol
hghkfrjhmrurpqgh	hgoghhioqlotptjf
hghknrkhmrurtqgh	smhsqlhlifqgmfnl
qqfrfringmlngugh	hjsssqmnnrttlpoo
qqfrnrhngmlnkugh	fjtpusjkgiriusjl
hujitrgogmsjpnij	sshlfknouhljggkq
hujilrfogmsjtnij	nifhgrpjtjooforo
ufpqhijkghtggggi	jpmounlhmofphjop
ufpqpikkghtgkggi	mhhlktlojhfntsmf
npotghrrnqpnhtrq	pmsksitumujkmlqr
npotohsrnqpnltrq	ujhnmfjghlromkll
iorgpnklqjpgjiff	hilloopjmmomfgsj
iorghnjlqjpgfiff	htjlrojsjsimjpsp
pnnmspqqhshuoiin	hqnknjsijmjknrqo
pnnmkppqhshusiin	tlfrtnnnffppilmt
oghfkrppuikpjifj	pgqpnsjliknfuphh
oghfsrqpuikpfifj	mmomnoshmnusugtr
mpgnfskiisfikggg	qgstkqgfqlqmkkmm
mpgnnsjiisfigggg	qkhmuomhqnoljtrn
motpopgiiiltiinj	ntosnnjoisfmfqok
motpgpfiiiltminj	ultkfttkuhtmukph
fngnlgrgloilsspl	ihfpshgmfjtfkgki
fngntgsgloilospl	nnklohqjgrpmttog
ffrisjkkrjtotqmq	ohmorpuhkppkqjfk
ffrikjjkrjtopqmq	girsiihofgmtmrts
puiknfpqnrlrpnrg	uunlmkqlttnsjilm
puikffqqnrlrtnrg	gktrljnqgpgtlrho
tjofpukfnkppkjfl	nprstgqqqplssuif
tjofhujfnkppgjfl	hnstulrsiufrutrq
ffmohtppkjhggpil	hknqjfujomgnjksh
ffmoptqpkjhgkpil	itqmsmlitqpgisrr
jojomsjhlgfgqosh	lplffpkhtoqggrps
jojouskhlgfguosh	pmklmrrnqgmuruir
strnlnplkfkmnrig	qjkjljnjoinujkio
strntnqlkfkmrrig	mtgkuqprlgrlrrgp
fqupoiofqsslptri	hfqnhkinsuigjqjm
fqupginfqsslttri	qqsmkmfmhtngtfif
pkpskifuplmigqkn	prggpuqqiriunkgr
pkpssiguplmikqkn	ullgthpsjitkjhof
infphrithmsgrkou	ghiqrirtufnnfknf
infpprhthmsgnkou	ngupjjhjofkgqfqo
gttqkplspqkohrlq	sfnonsorsotkqsmo
gttqspmspqkolrlq	uiqrpilghfkhkfnm
knkpqokjolmpkufn	kjkqhgnipiourrhn
knkpiojjolmpgufn	mqkhstsfnjgosmps
mgsitftolrqoimfm	gunjiflfqlhrjoto
mgsilfuolrqommfm	slgjligomfkihgun
iktlgjtjqlpjkrnn	nnmphngltnhimjqi
iktlojujqlpjgrnn	hpjqiifkqhnjfruk
ijmstqigrffpsofk	uhflrjogptggojkt
ijmslqhgrffpoofk	jutogqglrltuihik
pfniuoonpgtgkrrg	smjfufmqsuogfmpu
pfnimonnpgtggrrg	frtuoojtsujunogh
rhmjosihumliljoj	uojjrngjfkrgnthu
rhmjgshhumlihjoj	sgikgftruormlkus
rjqfghqotoqhpmps	tqihpnhjgnkmmmkf
rjqfohpotoqhtmps	glfjpsflikqsluip
huuhstitmmtogsgu	ntqnikknijrkgiqj
huuhkthtmmtoksgu	tigfjkhnlsfspnhq
rilqjgoqkjoomuuj	rstpfmpgrtpugtlg
rilqrgnqkjooiuuj	fujopshfufinffun
lkghlufhtgfprjqm	hnfopgtprjspstsl
lkghtughtgfpnjqm	igphtmiutnklurfj
oqroutfholfunihf	snrlqpmsfolukkjp
oqromtgholfurihf	qmjipsnifijmsprs
jnujiiqtggqotiju	uhgthinulomfkkmu
jnujqiptggqopiju	mnhuighgmlqtuogp
iungmmqtshjljfjl	pjfstiigfjluqqtq
iungumptshjlffjl	jtfisjlsjjjnqljf
ijfotlsrsugirktk	rrpjmqfqornqiqff
ijfollrrsuginktk	tlrgjtqtjplnhupn
nnussqqqknpfkqog	tjfpjshiqijmsrmf
nnuskqpqknpfgqog	frtpifqmhrrlmgtm
tjgrftogskmrkhhj	hhompfsqsuqunjrq
tjgrntngskmrghhj	pupimugsntmnqlrk
lisuqplfshkkhnlp	hglpnlooqmskklos
lisuipmfshkklnlp	numolhnlnkqosnqs
ggjfuhtuksphhmrl	jmjijsupskjotmoh
ggjfmhuuksphlmrl	iogohtqjjrsjslin
ogqrnsplgshmggjl	fkgprqihngjpfogf
ogqrfsqlgshmkgjl	hoiuhntkssiohsri
oslqhmpnifnslfts	qrjrlfgksuuuurif
oslqpmqnifnshfts	okhsqghsmgrjmtir
jnisuurmmqorqgsl	qoonqshkugjijtmn
jnismusmmqorugsl	kpkmmtoqouponqtr
nkfihqkjpuqptimo	qusuhmuksgpokiko
nkfipqjjpuqppimo	hkslpmkrsgqoiihq
munospjipmpghrhm	lhurgonkpmkjoshf
munokpkipmpglrhm	rpohktpnfrmqstso
hupiokquphsqtfqq	shfqtokgqsungkkg
hupigkpuphsqpfqq	qrohrgtqjigglroq
otsmjqonssrrtrjk	sgiirflktmhulqhr
otsmrqnnssrrprjk	nmoolimisikfqroo
jjkskmhgupqptkir	hkqtlrgiigsfnfir
jjkssmigupqppkir	ugfhtpntogrpottr
spiluttqqsolfttf	oirmqhqsrgphkfoh
spilmtuqqsoljttf	ruoinfikuttgfrtr
jsrlmsqpfnltgltt	pquuulrsnrrqmuqk
jsrlusppfnltkltt	fuinttutflottuih
guqsqkiuhoumqlrs	njupqkkmpqknhskf
guqsikhuhoumulrs	mksngrhlmoipnjgq
uunnltnujoqipoqr	msgulosnlqhilksh
uunnttoujoqitoqr	pgrsrpkpmoqtffsl
osolsnsnpslrjltf	uklogjmksrrtrtmm
osolknrnpslrfltf	rsksmorismhootjg
uihulmtkiintrsum	ipuphuknhjunhqss
uihutmukiintnsum	qkotufioptkrkurn
jjignrqoklmlsuul	kjtijsmrhksonhoo
jjigfrpoklmlouul	usipsqlgjfpgsutr
ljflrmltjumkkgnp	qktsorpfhlgtkjjo
ljfljmmtjumkggnp	qogpggqufihpfpjm
sjrujujnfjjnomij	uqhmmjmnshmjksjg
sjruruknfjjnsmij	iqpunqnftnrskfug
quoojsfqhmniltuj	uurtikpptjqohhfk
quoorsgqhmnihtuj	lluokirmusmmmoql
mlqnjklpfosgptsh	tnumgqkkrhnqggmi
mlqnrkmpfosgttsh	iqgkjpmnflpotfjq
fhmprgljoigkoslg	oiitkjinsmipmksr
fhmpjgmjoigksslg	sqtigrrigghthrju
gfpgmpsgjiummjhq	polhpgkumhomtnup
gfpguprgjiumijhq	smsgrgnftkrqsgfh
jfsqppgtmklniurq	onhilfgsquiihplj
jfsqhpftmklnmurq	lomolipskmromhrh
tsrjnffqpnikmtmq	sorlmnpgrkfmkilr
tsrjffgqpnikitmq	qnuoqpootpglsmtk
uhqgsljrjutkuuji	gkjtsjmjgiqtgkgm
uhqgklkrjutkquji	qnikhlmonnirsgki
noohfkskqlmoiljn	fsfjsnusqujnkhul
noohnkrkqlmomljn	quototonlnurnflm
kpoogumpmrtsmkuk	jpttuttotugmmkjm
kpoooulpmrtsikuk	jirfmmggohisqjpi
uiflphgpuiuiofsn	jqtkorjosqtqrqht
uiflhhfpuiuisfsn	pmloiolggugnglnk
ujkftrunphqhrmmn	lflrltfmsngmonru
ujkflrtnphqhnmmn	ijolkongrfpmpshk
usfgilmllmtoqssj	msglhhomqjrhuhgu
usfgqllllmtoussj	sttmfmntkihppjoj
ikhfolnsujigojqf	ktqfqitmgjlkmiif
ikhfglosujigsjqf	mtofrqtrjsnlpgsq
spokrkqirjulrgqg	fgfrkmnoufljokoj
spokjkpirjulngqg	tjrmftoujitrrkoh
jkttnmitlpngstsl	jtnqjnthmffolnnn
jkttfmhtlpngotsl	llrksqhnspnmsmum
kukfhiujjnkhqsnf	sqmgrtmfuqpojhfp
kukfpitjjnkhusnf	solqqnokngnfpgps
snqkilkqkhqhkmhg	ijoggjjrsostoqqo
snqkqljqkhqhgmhg	gfpfntglsprghgqs
llpflqinqmuhukki	hrotmsfsflnfpjhg
llpftqhnqmuhqkki	tlgqnlifkingqkmm
jjkrsjuirgrpoppp	gprfmtmmnrmnisjs
jjkrkjtirgrpsppp	msnlkgmnuujfufkm
snmufhnpssgjrgpl	omkhusiologtmpsn
snmunhopssgjngpl	uskhtgjjpkifrllu
nqlpkiuinjrjmqls	njhhnoufpskhpqns
nqlpsitinjrjiqls	mlfnrqnktfqlmujn
trrpjnsrluuiptgn	sfqipphhruqfimsm
trrprnrrluuittgn	mfppksprjouusoli
riqoomhqpphlskrl	tglttsrrrqqrsutm
riqogmiqpphlokrl	rnmuoqqfkrklhmfl
glklknfpnkkngtrp	gsullqhjsrpmrhkq
glklsngpnkknktrp	ljqkupqtmohtrkhp
nmgigmfsmhtoqqnp	mmjtstjspimmpsol
nmgiomgsmhtouqnp	roposkiksgpojkkr
kkrsnhftsskujigk	klugjqpgngttinqh
kkrsfhgtsskufigk	fmtmnnllghupqsmh
fmhfgtokqfufsmll	iijnfugtqfktsshp
fmhfotnkqfufomll	htgomjlsjllrolfu
qgnsiufhspugrmji	tuhjuioinmpghqui
qgnsqughspugnmji	nihshpgmgmsmpkgm
hknptmnhunkiikju	nmjlqrlkjnsrgnph
hknplmohunkimkju	rflghtopupoulpjk
mltiqsngprkttigh	pqoniimjlrftljhp
mltiisogprktpigh	kunpfiflmupmnntt
jmhhuhhlosmuggfq	psninljgrnioktnk
jmhhmhilosmukgfq	omjstujlpumnftiq
tfgqqinufljkgrmo	kshlnlnthtlsnuhl
tfgqiioufljkkrmo	phhmfqhgujmsjpif
jtonpfglhstuinlo	inrtfolhftsusiru
jtonhfflhstumnlo	rkmitumorolfhfnt
suiruonirjlimrju	ointoofhnjsptnhg
suirmooirjliirju	rhuquhghmkgqfppl
ofkprptkfktgoofo	uqnmrlkkhfkrlqfi
ofkpjpukfktgsofo	snqllfpkjhjkrrgn
gutkjksrkkfhjhln	kgnkpirmtsumnspk
gutkrkrrkkfhfhln	qplmlmlnlruikhtm
fgukhotrsrqmkuoo	jnmkmprfqrgsqjph
fgukpoursrqmguoo	jnipltlktrmifhgh
gnnmrjktsrtfitfh	tusougrjtlplrkot
gnnmjjjtsrtfmtfh	tfkkspsmtiqninmr
frokfqiufjpooiqt	tfqjhnoqjqufufun
froknqhufjposiqt	pgugssjlnjjjfkpt
sojuspinokqoftlm	prhikgpmnrljgnjo
sojukphnokqojtlm	mpjrgqmhrlqlpqhq
ikuujpmrgurlonfk	okjipgfnsjsuhgqj
ikuurplrgurlsnfk	imjmjmspjnkugglh
sltitfhfqhshikst	opunpgjtttlirosl
sltilfifqhshmkst	skilkiqhijjnmomu
rmmofromufjokgps	pkpipghirkmkufpu
rmmonrnmufjoggps	ppguufifosolohjj
ptipunfjtjssqqqs	lfhknqftsmfmlnjn
ptipmngjtjssuqqs	lursjuqjorumpgfi
kokpuijjjgftjiho	hqrgrshsiugkojrf
kokpmikjjgftfiho	ofgrnfojogmnsmmt
fithkprgqrfrpiqp	mffouploomkhjhjm
fithspsgqrfrtiqp	nlpfmlfjgsopkqqf
njfqfknjkrotmgkl	gsqplkqmhrsjlsnm
njfqnkojkrotigkl	pimikomuqunkgppr
uurlirmgmgorksjn	ogqmjnrmrnqrkiss
uurlqrlgmgorgsjn	nqlqigmigroknpis
gmmjrggnhussmons	iguirgrtomgpirhi
gmmjjgfnhussions	lujrorlsgtpunurh
uukljomjljrsshus	qgfrfnjghfuqfupk
uuklroljljrsohus	kjkuiuhjftrjmqkr
umgfqfrtfunmjijm	igqgnofmruhookof
umgfifstfunmfijm	hrukjtsfsrshjmjt
thuglgnmhqqihmju	fskjfoskpniqsroh
thugtgomhqqilmju	npkhhjsiljmmrsss
mpkukrmkpijihugu	hnllpjmfoklsrprm
mpkusrlkpijilugu	gslhrogljnskntnu
hgroqgljqisifnkl	rkgnuisthijsonrg
hgroigmjqisijnkl	fokfjkhnppgpsfpj
ffrhhhfufjmtrolo	gsgkjolrmsmnpuli
ffrhphgufjmtnolo	qlrphhgjgglijqkr
rmrifhmglqhfnpij	rhkjtjtluphjhlll
rmrinhlglqhfrpij	lgmhurprfqomflpi
luqhpqfggnrfpkok	opqqnrjnngimrfpm
luqhhqgggnrftkok	hghqghlhuupjmisl
ifoogufginshmnkf	lmkorqhoiruqrluf
ifooougginshinkf	fqpjipkuuksifhqq
jhorumprqhflsfjj	mqqslntjtgppourh
jhormmqrqhflofjj	hrstfluomjjnflnu
uouqgsognffhuslu	ghnptkqoglhrmgpn
uouqosngnffhqslu	gtgsitqftsqpfmlk
msuqrmkmouonqtpn	kumttjnsnlllkkfr
msuqjmjmouonutpn	msklofufginkolps
qlknphpifthqhufu	gsrunrtorffrksmm
qlknhhqifthqlufu	irorljtoksiusnrn
jugsjmhooihilmko	ruqfoktmsnqfskni
jugsrmiooihihmko	lpthggufrputlnlm
tliufnljmgpjjipg	shhfogntgjsjthpj
tliunnmjmgpjfipg	lghmlnqmnrnqfqmh
sigfupmhknurkhhj	shgphfpjfstfgfoj
sigfmplhknurghhj	hmkhtkqmrmlrfkoj
rqrimkluskphtftt	fpuiplknfprlurmu
rqriukmuskphpftt	tjilnoksmtitrkri
quiuonskfnthtolf	goqjfnurjiqplugs
quiugnrkfnthpolf	sponspkktlprprkf
rsorjqshmopitknk	klmhuiokpoifpgjk
rsorrqrhmopipknk	iopkhhhmgluqhtog
nqrfuumrpqugfjik	liiqsgpkogpjhnll
nqrfmulrpqugjjik	hqsiuiourftupnnq
irmnkprpijlmrsjr	snnslroitmffjmjn
irmnspspijlmnsjr	qghspjfugjinjhig
ktqiqlspgknqlmgo	kngnmpgkkkigftgf
ktqiilrpgknqhmgo	ikoqmtmifsmohlru
rgsgfoqrkiohmruo	qshqjriuoilgtgul
rgsgnoprkiohiruo	spkkpkgquktgrukm
lqkhrnnsoshkjuhj	nkisfuukursqstnr
lqkhjnososhkfuhj	mrhtnlkjoijfoght
hsgsrlftopmipmhl	opmmgrqmhjhptmpp
hsgsjlgtopmitmhl	hhqiskthsnsutkpu
oqutipgmmqfotgig	rnkgqrqhlriijgqp
oqutqpfmmqfopgig	ognsnklfsgooikhp
fkqfohtufrjrplri	kngnjsnkkrkfsgph
fkqfghuufrjrtlri	omnuujpmithrgiig
fplllngrmgqukgko	jjtrromtkpifpffs
fplltnfrmgquggko	fitktqhkjhntjlsk
qgoqmkfjlpujrphj	gsftpfrqqkitrshr
qgoqukgjlpujnphj	iiupiprlslujrsrk
gnmqmspkpihogngu	nqmmjipmosnnhplr
gnmqusqkpihokngu	hmmpsgogkmioljqf
mssmuolqothtpgqp	ooiklqokjnnqifng
mssmmomqothttgqp	mjourqhftsmpupug
tlpijnrorlntippk	rnthugflsrtqorpo
tlpirnsorlntmppk	gikjiurrkmrqrgri
qilgonokqnjsfskr	sshflpgforqpmhku
qilggnnkqnjsjskr	ifpmtqopjipkqtgr
lpshpfhmpjohljjq	tpkgoqrgpssorlqf
lpshhfimpjohhjjq	ijlosfputuituilg
jojguognjqrqhupt	uqgnsonojhiuilim
jojgmofnjqrqlupt	mtonuprsrkimnuqi
lhihmomjhqgrsono	qffgntunhloqojhj
lhihuoljhqgroono	tkfhpnhfriktrtrj
qinuptfprpgotrlp	sstjrinpupshkhqi
qinuhtgprpgoprlp	ukmuqiogkfpkpkpl
qjsnmrhksjilmpmt	sokgsihrtiutljkn
qjsnuriksjilipmt	fkffunttgknkqggn
fkrssnlsktlkkisq	ggutqmtqhtlfkgmo
fkrsknmsktlkgisq	oioujmtitofqirfh
rsuhgitnfrpggihf	qlkjnigsmpnksrkm
rsuhoiunfrpgkihf	jfqukqjqtirqphni
gqrpoqhhfouhtkio	kimnqlmpuunpotof
gqrpgqihfouhpkio	olruqtknlpnfhsht
lukgpjkmningrmgj	mfhhufhsmkpinjku
lukghjjmningnmgj	sopiouqrshkmolqu
osgulgjjjohrsitt	pmnhkijqlljnikmg
osgutgkjjohroitt	ktftsisnnmhhphps
slnrspjhhjtnkotg	tookrsgjppnomtjl
slnrkpkhhjtngotg	hqipgqokuqroimpi
troilphkqpsjsgqm	olintkmjjpppmlfn
troitpikqpsjogqm	hkinkifqokhhontm
pfhsksgkjijkkhnf	lgmspjsuksgorfni
pfhsssfkjijkghnf	gjissrmhsfiqiqgk
sumfjruhqnfnrnfn	kmugjfljuffnhgfh
sumfrrthqnfnnnfn	sisunronhggphkru
hpholinflqkrihsn	jsphjqulrmhgpmko
hphotioflqkrmhsn	unkrqgiurtflhffk
onmiugfpntmrkrso	hrrjpphuumujrigs
onmimggpntmrgrso	mpmplptumpihsnim
lftrrppqmotooggs	iuminphuslfuihig
lftrjpqqmotosggs	tkkhkthoqjnhnjuu
fmknnmtkjfhhgnfi	gontnrmosmhkfioi
fmknfmukjfhhknfi	fsntoqpintmukqto
qfroomqnppgmtsrl	gtklugniisnqmjon
qfrogmpnppgmpsrl	kmnolsimjsujurrf
gofkguhijtgumpqo	rpkfusmkiojpjijh
gofkouiijtguipqo	qttmfulkfunnsulq
gfkoolunfnhijouh	jlqjulstkfguisnn
gfkogltnfnhifouh	uuurqjppijhloqup
qjhuiignligkjijq	klrtolgjhjlunssq
qjhuqifnligkfijq	huutrfpqgspkstlm
siqmrulfuguknllr	kjfpfmkrksustlgh
siqmjumfugukrllr	okmpgumlgfiokqpr
kfqjtlrsjsmqnsnh	gntjmtifnipkhghp
kfqjllssjsmqrsnh	mhugnkmigrmknfmi
jtfsmumqsugpjgom	jkkpniqsrrhkkqnu
jtfsuulqsugpfgom	mkfqirojnkhjrmuj
gflkuitflifigsjs	ufrrsqofopoojqmi
gflkmiuflifiksjs	frguliqnshusfsti
numppntluottltml	imifpsfpfpkmqkpl
numphnuluotthtml	fslhqsoqquipqugn
hplgijuorutnnktn	qhtrkjkppttgqgqo
hplgqjtorutnrktn	mgunifuqhjiinipk
jhqkmtpptgpqklph	kjqnminjmstopgmo
jhqkutqptgpqglph	qsuiolukifklflpr
rljtiloqsffhhfth	rpjfhtqtghttrljj
rljtqlnqsffhlfth	mootpoqmnhffklio
fnttrothhpsnofsg	tqognmkljoqmtoif
fnttjouhhpsnsfsg	rnhuoigopqquursq
okghlnqksklognpi	uppqmgouurunpkjq
okghtnpkskloknpi	ikmfmqskmouujpqk
rmpssmgtjnmsposl	hfqkuthmgjuispno
rmpskmftjnmstosl	ngimqslumlsuusms
fsqrpffrjmmjpsll	oouoguufumgnhfgq
fsqrhfgrjmmjtsll	skknfkigqhikfhrq
qhqlfhhpjmknkoiu	jpjgrplqtgpiglpj
qhqlnhipjmkngoiu	ifsrplpjpomtomqf
kikpfsuunlhmhisk	ngitklrjsqphpkfm
kikpnstunlhmlisk	gtsgqsmtstfmmfjp
hfphmtotmhrmnths	npojqqqsgniguikf
hfphutntmhrmrths	jqsiolggqphrusmj
tjiifskumppikpfo	fgrjotqnkhhnguil
tjiinsjumppigpfo	sqkiokijlnsoskhs
ifhtsjmgrspmukni	nrlmsuprfpumqjjs
ifhtkjlgrspmqkni	fljsrmsknfmtilsq
polgtqpmjfgrrpgi	qusilkijquipmtll
polglqqmjfgrnpgi	rjslmkqkfohnuqmh
rlulsnihkkukmhro	jnhjklmhsillrnll
rlulknhhkkukihro	ghgmrnlnlrklurqj
nimrmuguksotpfft	honqiknnpgopofmi
nimruufuksottfft	rksgtrjrktuphrft
fpkhqptofpjlgust	fltpltlmkrjjpifr
fpkhipuofpjlkust	qjifqttsrqfinmno
jhuojjilpfujknoq	kfsfurtilifikfmu
jhuorjhlpfujgnoq	qnsupmqgorooqjtl
fnqqilhijfpnumul	nugihomjftpkpkrs
fnqqqliijfpnqmul	fhuolhmoljpkuhnu
ropjtfklsmumhlmm	rrjlhjruqfgmtprk
ropjlfjlsmumllmm	tfnirfuhptqmkfmj
fsisplkpgjrhinsq	umlqgkqlnqlpjrjk
fsishljpgjrhmnsq	lguuugqsmlrppjtg
ifungoliiqjjhmip	lqqgkuukjkrfinnu
ifunoomiiqjjlmip	mnfgripfhpomltth
fkrnumshmiigruoj	qitmkkltfrnsnmqn
fkrnmmrhmiignuoj	qnmpnjpgngtupnri
kfmklhfthfnqgojk	jrprmgktuothoulk
kfmkthgthfnqkojk	fpkfjjulsnpggjgr
ofsjonqsnojjtkot	jroumgjmpghtlpss
ofsjgnpsnojjpkot	uhlqnkfqglfgmkoo
nputmjsmoronjhhk	lsolhmhjntpghloh
nputujrmoronfhhk	qjlkpniiujpfiois
qflnpofuiorrqprj	ttlintunrkgnjgjk
qflnhoguiorruprj	phimhgfuhgilolgo
ofmkltuqqospglqn	mhrliponjqfgiopi
ofmktttqqospklqn	fpqitrtnttlqhuoi
flqsqrliumrflpoh	qmrtnttgisosnitn
flqsirmiumrfhpoh	lnjklrgsskgqhltl
iqnnjugijqrskrmj	qftjpiupioiijqfj
iqnnrufijqrsgrmj	ffnukikmlgnrmlsk
qouljoilsjuisirg	tglgutggqpslulii
qoulrohlsjuioirg	mounfllulkjmrorj
osukkstjfnujuksg	qgrohsflqimgmfiq
osukssujfnujqksg	hhsimkpjnituqlug
rjkplhfosjjfgspu	lqroltqgsfofhjlt
rjkpthgosjjfkspu	ghujgulsosmgkhtt
opglunjsfmlpofng	hqpmqfutpqjjnpru
opglmnksfmlpsfng	qqrfilhioiflslgo
olstqgjmhgshgojh	igisgpnpulktrmrh
olstigkmhgshkojh	gtlqpiiqqngslnhk
fllpotmnmrmgmsho	mtffpnhslnkhfgop
fllpgtlnmrmgisho	snikjltrttpfskou
hnnkhgutmggistmp	jrppppghkkjmirin
hnnkpgttmggiotmp	joltsstoljutmqtq
fujohktmgmlnofpf	rtkrgmtpqgtrrftk
fujopkumgmlnsfpf	frtthfguugmqfghr
jigumipoftlrhitn	olqhhphulmqqplkr
jiguuiqoftlrlitn	hqmohkgosgqutppj
ohrlufutokihqnij	fhsiqliutllkujiq
ohrlmfttokihunij	mmhsonmpiunhjqfj
lgjpirltofkrufin	lhsplsoqkgufqmuh
lgjpqrmtofkrqfin	ipmjjqqshfhilfis
iigsqoogtrokrjff	rquppmnumpllmjst
iigsiongtroknjff	pfiphrqnkhflfogp
urkirrfktftqjnff	hjfhttflqrtrggpq
urkijrgktftqfnff	lfqltruotpmrrkjg
ihtrkpniinlpjosi	tmmqpmqiqpftrirq
ihtrspoiinlpfosi	lhskjnkpftjhksuo
knpknjpisghhogfh	rksjfouufophjftq
knpkfjqisghhsgfh	lqgfphimlhulmgmn
munhuuogqtilstis	jiriiorooqsnnumo
munhmungqtilotis	lihsmthunnfnqhiq
qtfuispprhsnnpni	urnkhinqojqjqifr
qtfuqsqprhsnrpni	fnnghpntsosshtqj
hrqrrnntsqnhqftr	ltkqnlnmfhmmtmmr
hrqrjnotsqnhuftr	gjmltlqktkoofqgr
jgsplkolofulqnhr	oksshquouuphqrsk
jgsptknlofulunhr	ffktkhmflsfrtqtq
tkpgjjrqmpjtnksf	omsmknfmpugilslm
tkpgrjsqmpjtrksf	lihsfsfkksiupktj
jplrrtunptklqmkj	fgppmnptrtrpohmj
jplrjttnptklumkj	rihlujgukjsiiolt
rnhmjmrtlojlojut	mohihqrfulhuihrf
rnhmrmstlojlsjut	unpstiontlfjpoig
qopkghulojptmosf	jhinpunilfhufhhi
qopkohtlojptiosf	glisnhqfunggnknk
trplnlpukiukfpsf	jppfmgtofgphpkpf
trplflqukiukjpsf	jquimunfplgkipmp
smtomsjgpfnopomi	kkpqfhnpqkouumnp
smtouskgpfnotomi	rmiqinmutpfsrjmg
luuokpkluksfjpsr	mfniukuljqgjfkfo
luuospjluksffpsr	oskisnlhtqjqmqkt
jqtuhplnspsntosj	sphtiimhlsnontqn
jqtuppmnspsnposj	golosjkmntmhmtoo
monikpolrgmhkrtn	nhpqifusmmfhfufh
monispnlrgmhgrtn	plsohmnuriftsgqj
qkmmfqffrstlkrpm	qsikumtoinfprfpm
qkmmnqgfrstlgrpm	olnkufkfimjjlhgu
mmtffjtgqkomjqqh	gfonptpqfklplhpp
mmtfnjugqkomfqqh	iljujipkoumspgrn
lnirqqhplhjqnomh	njjqshnqujqmunnh
lniriqiplhjqromh	rlmrgmhhnsiilppn
qppfojmplgtmolgk	lolqhtunloitohjh
qppfgjlplgtmslgk	iknpjnqntrtkrumg
phjmltjgpruhjfti	gkhsgmshttfgsumr
phjmttkgpruhffti	imgfmhusuktllspp
ikqhiogikgpfnlpr	iifnpqjmhjorqoth
ikqhqofikgpfrlpr	gqiohjupullpfgrh
uomohrrjiukhogjh	qqiqkhptltqrjhps
uomoprsjiukhsgjh	nskfrgkopmmktjfh
hrkjgpgtjtrnpjkt	ifrjmkurjphjjrso
hrkjopftjtrntjkt	ukgmjjtrmgkhfthk
gjgqgfkpiijkhitr	pgfgkumtuimfmohg
gjgqofjpiijklitr	jqnuhtnpnkfpmiqm
qjoqtoqhirlgmhhh	uppnrgosqjmmtlsh
qjoqlophirlgihhh	ognituguroflpqsm
qimkiujpjjtkgnlu	osikhfrqkngqoupf
qimkqukpjjtkknlu	gogmkllokmlqmlht
ltomfgthoprisint	jsgohtjiroinppul
ltomnguhoprioint	rsqilmqqtfjgmqmq
plhnshpmtihsfppl	pshrjtjinnjptiqq
plhnkhqmtihsjppl	ghkjssoksoouqilj
fmsfqklkkulkjpom	luisrmgslkskjtrm
fmsfikmkkulkfpom	uojtgprjqfhssrkp
qqknqmumjioiponp	jgjhjpgnhllpqtrp
qqknimtmjioitonp	kgmluosjtlupghgu
hfhgrhrfsnkuqnns	irlmmqkhqqijkhfr
hfhgjhsfsnkuunns	igkmkqmppgoutnso
ilfhujgppfminhrl	uhhhqfmfkgtroqou
ilfhmjfppfmirhrl	mngnphtotqkqlrru
hiunhrptpqpnsqns	qlqllhijkunjrgsj
hiunprqtpqpnoqns	pgipgumrkhqpoulp
hqsgfstrmqlhfqrr	tjgtmfqgqjjpmjoo
hqsgnsurmqlhjqrr	tnlqimhsujpgjohh
nmkjijhproplpgip	hupsgokitiupqjfq
nmkjqjipropltgip	ftttkjpgtllutmkh
imlfulsjfliguuhg	fjmjqlqtiiriroii
imlfmlrjfligquhg	opimhloruiqimuon
mojhugfknlrljmol	mktjgoiihiskpphj
mojhmggknlrlfmol	hokmsoullqttmjhf
qufphtmfqupglfph	upfmmijoilmnssho
qufpptlfqupghfph	spnrghpklotkfohj
rmlmhslijnkkjifj	rhlksfmhhhrroiqn
rmlmpsmijnkkfifj	qplqfsgqilokpmkk
jhkoumugkjjihrjs	niluqpflujrnmoth
jhkommtgkjjilrjs	iqlmkiiqipfmqrrr
tsinfnpolhuhjmln	supltohhkiumnkup
tsinnnqolhuhfmln	toushmigfunjrtjk
utipnfhoophkjluk	kgsmigquunsmjsri
utipffioophkfluk	pnmjnqspptnmhnfj
igjlllljnookoroj	hgulusnqlkqltsft
igjltlmjnooksroj	mgrnqssorhjisqio
nthhnlrmgqgrpimu	lugnspnupuhgooom
nthhflsmgqgrtimu	lsgumlmruigffsfm
stolklumfumkktgt	tkkiingilqilhhhk
stolsltmfumkgtgt	fssuhstitfgsiutu
koqqhkpnnsjtmjpk	huohljuntoqrtilo
koqqpkqnnsjtijpk	monrffutmstolomj
fntikuttpisssrpj	mphjsooqussiurjq
fntisuutpissorpj	uphhqkjjlqiugtij
fjjgfiomikiugrfh	qtmjomlupiqmljkg
fjjgninmikiukrfh	qsqftnlmkjthjnml
ursrghrshgmhkttm	kflujhspflshjfun
ursrohsshgmhgttm	ttqmjmkguptmnrfo
iuiskgtrjonjhkmn	qnfqlhuijjrrqgfg
iuissgurjonjlkmn	llspksrtkqsjjpfg
onuhujqfkskjrfjk	ighgjurjfhjfhjkt
onuhmjpfkskjnfjk	kthijouptsltqprl
ujipfniqkfgfgjpk	irrpjrlmimqkhjms
ujipnnhqkfgfkjpk	kjrqigfitjqjmqqo
tuknuqotlqruqlkt	nmjfrmuonsihsnqf
tuknmqntlqruulkt	ksnppnofpkgoujni
rmogoqpufksjkrsp	pfmmqhukqtlljngm
rmoggqqufksjgrsp	irsjgrnqsuigromh
qqogutsrmsqsufgf	thrlfpkjsgjuqfrs
qqogmtrrmsqsqfgf	oqqgktokokglukpg
hspkfnuggftmrjut	pjgjppfkfultqiol
hspknntggftmnjut	oukhkglfrolplfrr
rtromgfkikpglfgu	hsulunukgfunnlkg
rtrouggkikpghfgu	fpknshsprtjrjmqn
ultsgposfmsittuo	qthktgjtgsoqkjjm
ultsopnsfmsiptuo	rlqufsrmuqhugmor
fjikiiksnmjprrrn	fogrupkilupogfqt
fjikqijsnmjpnrrn	fmumurqojtmrjrhq
glsjrlksopffflfj	huqlkmufhsgfgoit
glsjjljsopffjlfj	qlginqmgljjufmif
pjgiohinhonugoji	msugintghljrltit
pjgighhnhonukoji	ktiktomholsqsgti
ktisuoolsjrjulom	hknmnjmoggmtjfng
ktismonlsjrjqlom	rothtuqhnohpunrh
onorlunsgjfrtnln	lqhsmgmtikjtsqtn
onortuosgjfrpnln	qrltrrfunsjhmsjn
tujrqtuujmgnpnkf	puqhihntkopqltgq
tujrittujmgntnkf	nlhpjuiinupmujnf
fggmtsfnujkknpkm	sqgrkhsotntufjfp
fggmlsgnujkkrpkm	grtnhmufopnjjgfs
hoshtguunntfrpqq	kkonksjtfolqfltq
hoshlgtunntfnpqq	umqossfinsqggsom
mmppmtlurjiufhui	nrnljtpiuprinhii
mmpputmurjiujhui	fnflsqssurtoqomh
jtgfukjsgmjlqjnu	ioqoofrrmnifrhrf
jtgfmkksgmjlujnu	hrhmpqhohohkhnuh
fjmgpmutlroiotrl	uunshjolqfqrmjuh
fjmghmttlroistrl	fpiqtolilrorfhgr
imthfqknpnplijli	kigrgiptkumpmjsp
imthnqjnpnplmjli	tnulqnuijsqrurfo
pstnfrlhfooigigs	lkprqmqhotjrfkig
pstnnrmhfooikigs	mflrsqksojiugjtt
rpmthqgkiimjutsi	kmjlmmgmkjmmgtmg
rpmtpqfkiimjqtsi	othikhjktossssoh
huljpmrfurrssjpn	nookqrrslrjnnijo
huljhmsfurrsojpn	iftimqupuugsfqhq
jiljqsmjkftkuisg	niruorqspnjpjosl
jiljisljkftkqisg	lttouisrjfljfmsn
gnhppjnrnqnpnnmf	kpkijkumoslrtpsj
gnhphjornqnprnmf	upkhkkpqiifpfrjh
jfllmrgrhngrmhfp	jlpqtnujppmmhhgj
jfllurfrhngrihfp	otiluuispktjhfhl
shlfugpgmkkmumpj	uuuiimhiriufjlso
shlfmgqgmkkmqmpj	rksmnfiohfttusmm
qnjgjilnopkqlogp	lqgnhkkmjukhrtti
qnjgrimnopkqhogp	firfogkuotrqsrjf
tjmkufijhqnqsuls	khjsmjknnrolnopq
tjmkmfhjhqnqouls	tqtfsiutpifrpitq
hrhsqrghnshjkftl	gljpoonfpofjkftj
hrhsirfhnshjgftl	romlfufojjjrfusf
omsgltmshlgqrpuk	hspfujuhikimgqih
omsgttlshlgqnpuk	rtgopnfjprilskfo
nqmmmksifgnhrrfu	mntjmruouhgtooku
nqmmukrifgnhnrfu	fkoimnllnnkilljq
kikkriktkhstrjrm	tkfhkogljppknqnh
kikkjijtkhstnjrm	pfromiqhlnlsqjmf
guqjuugishlrsssp	itgkpmorqtoktsrq
guqjmufishlrossp	rmnftpllugjtpgsu
tsrssirrqkoqtukk	qhkootfuojurlrjn
tsrskisrqkoqpukk	qpgogkssjuplugpu
lnfphfmjsgnsgskr	uohorfjkpntokpjt
lnfppfljsgnskskr	onrkrurmpklmhnst
rgtqmoplnqsgpmrh	pnosftkgjrnqkfkt
rgtquoqlnqsgtmrh	krlstsojsjqlgkjs
plkfrujjqofkkfis	rfpqpsqgimkljlph
plkfjukjqofkgfis	llottjqupoksujtf
rijughnurtlinill	knlsmfqojunqfioi
rijuohourtlirill	jkgrqhrjiogonggm
ikfsfnthhrrrjlqu	ngjontjftfnujupq
ikfsnnuhhrrrflqu	gnlsouihpjqpkpou
ikfofggnrgppklql	mfoisqlfpqnrrhrj
ikfongfnrgppglql	ppnlqpqkgknomigm
nqhfntpjothmkiom	isolrstpsojojoiq
nqhfftqjothmgiom	lgtfjplknmqjoikg
sfthnhhpslrforrl	lhjfsipjqsouslqp
sfthfhipslrfsrrl	jpkrhmiplhpflqij
piuiusppkjooojhn	nsmumrffihmrfshu
piuimsqpkjoosjhn	hpisulhmnfunfhrk
lptkogggmhmnhtkn	uumngulknpfhksjn
lptkggfgmhmnltkn	ijgoogukmgitkjjf
qlhhnflfsmgkmhqs	rohhrlrostorihqp
qlhhffmfsmgkihqs	nimtfuisuulmfiou
sjsomtmfqmhgrifl	roqqjsukithqmgfu
sjsoutlfqmhgnifl	jipomsuqrhqogtkf
tmlgiokntqluuttk	hshfgmgorurigkoh
tmlgqojntqluqttk	ophukluguopoiimt
sjtkjprotkuulkil	knuojpoufutpmhgt
sjtkrpsotkuuhkil	ugsohjnhufpkrqfk
nsttnrngjmgjkpnm	utgsjlhotqtjsigg
nsttfrogjmgjgpnm	luugksnntgqltjlg
flntflkthgppkifm	rrkifkrrlnjjksmh
flntnljthgppgifm	tprilronfmrktpuh
puqkpimukqfusklg	rjpksojhplqusiut
puqkhilukqfuoklg	mptftgnkfhnmjrmo
onttotjtoghiprpf	ohhunuotjlpromig
onttgtktoghitrpf	lplijgojhhnpslfi
tlflgiufsffqjpsf	onsoktlqqoqmojsf
tlfloitfsffqfpsf	ugshhnhgmjtonfnm
hfqjkssrjolopthq	qpjiuongiouigqok
hfqjssrrjolotthq	ihqjmfpnhsujokou
gphnhonhpogulrso	igmqohumrjpsfrho
gphnpoohpoguhrso	jknunpqquqiriqus
polstphiujkiijup	hsfgiuhknumjrnii
polslpiiujkimjup	urjjsfnhkkgttfqn
fmsllmluggiigpot	ikmspgtsuuugqfuq
fmsltmmuggiikpot	nqhnnjsjpkioiprr
gphknqfhttumlhlg	qklnotkfmusptqgo
gphkfqghttumhhlg	tugjokfofngmjfgk
utnqlnqlpsqokjln	ihnikfnpnmoquffh
utnqtnplpsqogjln	urgfmurnumillnfh
kqfptlljfjkomlmi	rphiihooigjmsrgp
kqfpllmjfjkoilmi	hgnmifgnnlslpmnp
thqjjpjpijoppunp	hjmosftginmnliro
thqjrpkpijoptunp	ijmknqmkrighomll
sgsnsfggmsrhfpsp	qpsojnlrijsrnofn
sgsnkffgmsrhjpsp	gkruntijjkgkqftr
lmmqmfgmsrsrmgio	kfhgnonqhoiuptkk
lmmquffmsrsrigio	ljrpttlgmkjuitqi
pspuqihgtmhjtlsr	mfjhkslnulsskqkr
pspuiiigtmhjplsr	psljokomiosfmqsg
lkkrthqplqpiflgq	jgqgpltpomhppufl
lkkrlhpplqpijlgq	nnssffgnohohgrth
gsjgijuprrikgqiq	hspjfnrjqllljgjg
gsjgqjtprrikkqiq	ruohtftpgfknnrmn
fhkkgijktuntfphq	flsslmitfgskgknl
fhkkoikktuntjphq	stnffqpphqihmrns
inojfkuknjfqkgjm	opgtnlunlpjlmqgk
inojnktknjfqggjm	qlmiilkgopknqtku
jnhtsnorijgjqpph	knthjlmmnonhgtik
jnhtknnrijgjupph	gsngjmqomjsoqkpg
irphrgojkgqfugnf	foglluffrflirggj
irphjgnjkgqfqgnf	pnjgofmnnhujfmuj
lqtujfrpoksouimf	hkiqjkhtkmnktjjh
lqturfspoksoqimf	uhppngrqorfuirlh
tsrgqprgnntnltqs	jppjfkigmluojihn
tsrgipsgnntnhtqs	lmnnirqnsiktnlpf
nniqirlispghkjng	tpqlljspqnqisnfu
nniqqrmispghgjng	qnojhigshnghonhg
hfoirkjjmpjnsgrs	opgpttktqmjjtmgu
hfoijkkjmpjnogrs	jrulpstipfopttlh
npmgjtnhfikosurh	pgkgjtksposqiojm
npmgrtohfikoourh	qjlpjumlrsfiqfrr
jffmrujmsppgiqfs	rgguplkhmuulijfs
jffmjukmsppgmqfs	sskiumojolnhuhml
fmlpoonphtsmnhpg	kjtsihfttjmfioqt
fmlpgoophtsmrhpg	hloljmshqpsqkpfm
jrgfroiuhujjqspo	shuntihnpihtpmps
jrgfjohuhujjuspo	ifmrkokotpomspls
iqulqkmqknjuungk	itgooirtspnjnplk
iquliklqknjuqngk	ojsgmjiktmpilsiq
fqrjtthtmkjpjfmo	tjlrojklqqsfmqhn
fqrjltitmkjpffmo	quijuopjiomkqoug
qhonoijluohlnhfl	pipggunqqrtkhpgt
qhongikluohlrhfl	luhttgknrthukrst
ipjhpgsphpjlmgnq	tjrmtnljjkhpriqu
ipjhhgrphpjlignq	noplmsiumupjklrt
glqqgmjrltqhhrto	lqqfufoqgmpproru
glqqomkrltqhlrto	ltspqjqmimkrmgjm
nomfqpgrourirpfs	krkpsulptfouqpkq
nomfipfrourinpfs	limmplmqqhomulsm
hijmlronmotrslgp	lioiffginnqhpjtj
hijmtrnnmotrolgp	jmphqmlkghnnsqtk
jftmumgrumnosrqq	nlqjusfslokusiru
jftmmmfrumnoorqq	mksklqiukjkjmkfl
thmnrigiosotunpl	olhofoufsqpqphsm
thmnjifiosotqnpl	filptfgqohthgjqr
ikmittlqnotlulnj	jhllhmtkjhjrojjj
ikmiltmqnotlqlnj	hgpqhisluinqptpq
pfnkrnuggsoniukf	oikqqgijjnpnmoii
pfnkjntggsonmukf	nmmpphorjgprgnph
qluqjrigjouumhmm	hktkmknjhknfkmti
qluqrrhgjouuihmm	jmsgnhjntimqpufh
itolqummjhfnhgqi	qgmsfjhpqkkhtsoo
itoliulmjhfnlgqi	plnnnkfgmmgftosn
jhogssjgnfpnljgs	gikkknurkntjrqmm
jhogkskgnfpnhjgs	hujsinfposiuguhf
qqgkopoqfjplmtrt	njnijiisujnqljrs
qqgkgpnqfjplitrt	llrmfnlghjtkpqgq
kikupqfmpnptsmls	rngploofnlksojfo
kikuhqgmpnptomls	uhngtrusmppuqnlq
rosftjfrqmmhfgmf	liplqfggmqukjiqk
rosfljgrqmmhjgmf	tfjlnoloqqkrgnmu
ghmuqfkfnhrfktls	gjqltoosokpqrqpo
ghmuifjfnhrfgtls	srihlthnujoporpg
ftpqornjigiigffm	ksjnqtggjrgtfqgf
ftpqgrojigiikffm	msilksgfpumqpufr
uiknklpqsprlrkhl	ifqmiirrokujrtnq
uiknslqqsprlnkhl	orjhjkfjprtnnrjs
rjflqolgompfqmlk	rpkkklofmrshqpku
rjfliomgompfumlk	ojfftqijqlojurpj
uuosjlutthgfiuiu	kirhmlhuinnjtojq
uuosrlttthgfmuiu	posrislqpgikkgfo
pkumhjokrgfrrpmu	hnlrffrjohlkifft
pkumpjnkrgfrnpmu	lrthgpifnqmtkliq
ishuuimppfilfpln	lgnlfofpsjrsnuhq
ishumilppfiljpln	mtlolslhkoqfgtlg
nfitoimlhquqtufj	minillspjhkrhitu
nfitgillhquqpufj	honsmpfnrnnstfpg
fghifrnhflphltuf	hltgjikipmfhiuml
fghinrohflphhtuf	rnkuoifoionhhktj
tikuukrhmnmrhilu	ukioousnqmqqknut
tikumkshmnmrlilu	qrsinrllntptkphu
ujsrpktmnomgrooi	iglqmmnofpqnhkfq
ujsrhkumnomgnooi	qolroouttqqgrpfg
gugmfqqrktmfrlti	fonihhtijgglqtpp
gugmnqprktmfnlti	nfqpjnusgtksgmmt
hsjljjqntghkihij	koruojhsojiupthj
hsjlrjpntghkmhij	nnntnnigmnuokgqh
jsflqtunkoniiisk	kunffoqlqsjgkllq
jsflittnkonimisk	jpogoksiptmkhmmr
hogokgmuqfhufuqu	sgsjtgqkljqulpmp
hogosgluqfhujuqu	fhhigoqmghngfoos
kilglkjpjihsglom	nplugtqqltgplrmq
kilgtkkpjihsklom	mfstnohjihrnthpn
mpstrghtkjrnihrr	uoiitihsjofthmtf
mpstjgitkjrnmhrr	ugunlptiglijppps
ktfntojkuquplmul	iqnrlgnuorikjtrk
ktfnlokkuquphmul	tisnhffjpqnptktu
gqklkkoglijgkugo	qpmstkigfmijiils
gqklsknglijggugo	lhtuupnlmkgoojoj
nmptrotskgkrlguf	nilojmigpigntrfm
nmptjouskgkrhguf	lhkgggtppfsrlili
oqnlrptjrpukugpi	qorsntgptopqqnff
oqnljpujrpukqgpi	pggolltrijsplfup
qhojjiuitftfmmkj	mruuklhtsmrjiqgn
qhojrititftfimkj	potlfhnfotkgonmg
ffjmuljnjijohori	thlsqmisisjsmoko
ffjmmlknjijolori	phhsqmsorroinfmt
rsgorngglihomhot	jiqsjitoprhogkhm
rsgojnfglihoihot	nqiimskgfufjngss
rkhtpjpgksurumqs	lglifnotstsqlmfs
rkhthjqgksurqmqs	krihhpmtpnsltlhs
unirihmfmgufnjst	smuiitolkftukmnj
unirqhlfmgufrjst	nighrguslmpjiluu
smjjnuiqhfijifpn	irjtilmjmupgrpng
smjjfuhqhfijmfpn	mugfjrtklltruojr
klnuphkgfptglhqq	opnstsgsjjinhifp
klnuhhjgfptghhqq	ukfrrulishpqkfos
iouqipikssjjlfio	nkooosilnssultno
iouqqphkssjjhfio	rshkrmnhtlkkiplq
fkulmhkrsnsnroui	gojjkkifffmgrrok
fkuluhjrsnsnnoui	qpknnliisrkoqnnr
sitijrqqfmknhtgg	jhmhmsulronkfjqj
sitirrpqfmknltgg	miojjshhssuqmiti
upflrfgurilijtfo	mgngsgghfjfpjtoq
upfljffuriliftfo	irpnrrtkiromstml
ifiptjtmiqsknpfu	krquiphulsnhsjjo
ifipljumiqskrpfu	nmoqqkmioijilnph
llsipoqqqkrlrnlj	lsspnunijitmpnpm
llsihopqqkrlnnlj	hspgtkrhgtgigffq
iunqflmjfpthimtl	qggqgshjsfopninu
iunqnlljfpthmmtl	tosmrumlqklliiqn
phogiqtqnphruqtq	ssgshisrmnfsmkrt
phogqquqnphrqqtq	gqispjmqlkimhist
tofqokkkgnrhqnuh	hghoufhtqskrftpr
tofqgkjkgnrhunuh	trusqhsqohsoshif
skuimfulnlhniqhk	ikhijulokfotntmn
skuiuftlnlhnmqhk	mnuurnssnphljsus
gqfuklohkungptsf	rmuppigpjifmiogp
gqfuslnhkungttsf	rmlutlrurlilksoj
rmslliohnqhiiqrh	rsuifgirgktjoqtk
rmsltinhnqhimqrh	umirmjpmshgoluif
joqnoiqmpursfroj	ltqjusulogsrsrur
joqngipmpursjroj	smqsuqotpkjmjigk
suqkqjospffnujok	mkhqqiuqitiulnok
suqkijnspffnqjok	osrfohnnotgqifml
itrpnukugonmplrp	infhtufhqsuhlmpu
itrpfujugonmtlrp	fgfhgojoulmfjquh
ojtphlqorjjigmir	jqnnuilofpsfqgnf
ojtpplporjjikmir	qlssfljshtumlnom
suokkppqqkttpstf	jijfokiomrruflsf
suokspqqqktttstf	jsmomogqirrnqiru
kusgmppuqmqfqqjs	fsslkfjrgiuhnllu
kusgupquqmqfuqjs	qthmjsspirkmorhf
ppqonfugjkjgtghp	qrsnnmogrnkfiiks
ppqofftgjkjgpghp	lgitrlhkirlghtrp
tjkimggqmirpgmri	ptknroufjirqlojt
tjkiugfqmirpkmri	iliuhtmjtnopjoqi
tnkputrnjjgmphui	pnsmtmnnnksgjruk
tnkpmtsnjjgmthui	sjlholgjrhnfirps
fgppgpistosiglul	ihphurtupokffqmg
fgppophstosiklul	hofquqrhjpomhmqs
lfmifqrjikgtglmr	nglhntsgqnmqtfqh
lfminqsjikgtklmr	hntortjjqhitgpqi
otjpinpolrunjrfi	jhhjnfihfhnugllp
otjpqnqolrunfrfi	shkpjkgfjnsmgoro
ijigpsukhsrlrouf	flgqhoqunijtfmsf
ijighstkhsrlnouf	gqfkimqkgtnffilk
tissroorltjommkf	hogkruihjpmtihgi
tissjonrltjoimkf	jfikqmkssglimfnk
gfjluplusmjhllfu	pstolsttmgjftsol
gfjlmpmusmjhhlfu	inrjspnhimpmpfsf
tufltsthoojhhtqo	ikkfgkonqmnupsnu
tufllsuhoojhltqo	skomktqojmoipoum
qlkhrsmjufmrpjql	hkiqqkmklprjrtsi
qlkhjsljufmrtjql	ogfmogqogitkrifi
pgjknolkqnjhsrhl	qoninmsprmhnhpll
pgjkfomkqnjhorhl	tikgmlpqstlggjjs
stoiiflfmqjptlfs	imngpssppqphrhmk
stoiqfmfmqjpplfs	truigtktugqmqmpm
kjmjgnnsqmhlffpl	irfnhiquprpmurgm
kjmjonosqmhljfpl	mnnoiusggfmmrmpf
ritlrpuujhohkkjk	mijmohusrqhjpfgq
ritljptujhohgkjk	tmpujjntnjmkihjo
fspofrpkgikfgpfi	olrjlnjguirsrpqp
fsponrqkgikfkpfi	kullgphkumuuflgo
qpkimrsmjtrrlims	imporpfsmurorpuf
qpkiurrmjtrrhims	qfkfkrnosrjpionr
nstnjrhnmnthqkoi	ujufhstqllnfsufi
nstnrrinmnthukoi	grfstgliffuhhhgu
tuimlfukqrgrfpik	krjtgqqhhkurprij
tuimtftkqrgrjpik	giisojpnmqlhnirt
ofkostntuorukpgp	snriqgoggkgglsif
ofkoktotuorugpgp	qjhmsgpopgoirtlm
hrqgtqsqspjirlfi	oohsqghlrhnlnqrt
hrqglqrqspjinlfi	nshoihsunlquhqgt
nrpkoftgoimtupis	nsouiskllggnhoif
nrpkgfugoimtqpis	uknnisghfkqtniij
mrsjjugriggqnqqk	kgiofnosmqjipgkh
mrsjrufriggqrqqk	rlrsrjmjiuqimrnf
ltlltpnspmglqqqj	nnrmggrfrpfjffiq
ltlllpospmgluqqj	honuklthgnunpjss
qnjlsogrgunnhtfk	sqqhghunoghkugiu
qnjlkofrgunnltfk	knpgsngspsgkpmpg
mhqqqkigrkssoqiq	onhgqfsimqiqnphg
mhqqikhgrksssqiq	tknjsprkljrprnps
ushgnmufgrltnpsi	uouqhqtjstihtlll
ushgfmtfgrltrpsi	ljsqrkgsplkghptn
jsgoonttklfkqfuk	uptrjouugipruuju
jsgognutklfkufuk	hoioqpkkikkqplti
mtkljsqfotkqminm	iifhflgnntnlpqqm
mtklrspfotkqiinm	rnmsmgtlpjugfruu
qmprknornpuljsiq	jturgnhqonopsoqt
qmprsnnrnpulfsiq	psmhkrfrhhqgtojm
ifpklipjigggfkrk	tfqrnorktrnkmprk
ifpktiqjigggjkrk	opopinfgotkmogtt
ugmftqoumqmgslgt	miksupinpfpkpojo
ugmflqnumqmgolgt	mohoqkroouoosifs
lkqpuotthqnqqusl	fhkfhritghunoksh
lkqpmouthqnquusl	ukhhjmnukoirromk
rofhlgtufhtusohl	tofqolrphiuhufss
rofhtguufhtuoohl	plkfnpflipfguffm
phpfggujspmpnjnk	jgmrkrprommnpptu
phpfogtjspmprjnk	jkfuiokgflpufrgu
qplpjnqukgouiqfr	srogstkfkofjjnmj
qplprnpukgoumqfr	stttnoiqptomsloo
omoththgulmtqgfs	lkpjnqoupngirnql
omotptigulmtugfs	ujrtumhlmjjuqgnp
rnffhusmqufhrhmq	nrqkjnsukhlomili
rnffpurmqufhnhmq	lpplfppntrhuqfpk
uttgolunogktmgis	rrgufpprsusnfflg
uttggltnogktigis	jhoomhisnqqqootn
ljhqunnlogkosiui	htqohujflumnjump
ljhqmnologkooiui	flqfujsjtqsfmlnt
kurlfoqrrfsjtmjo	pqilpjqjjmqpgjkj
kurlnoprrfsjpmjo	otqgmirhttftkuuq
rjmlhikpkuosojgp	sminptmskqnsnrtq
rjmlpijpkuossjgp	litfguqihkfpsltm
htplunlrrtqhooqu	knootkgponplurfj
htplmnmrrtqhsoqu	snofqtttttplofto
njppnlipholoqrpf	sfjprsqqruopkpfm
njppflhpholourpf	gskqojmjinqmgnkm
ohgfouihrfihqiqh	gsorrmilpiujpjmn
ohgfguhhrfihuiqh	pgrlkrpggushtsip
ijnojoojkrrihhsf	mrrsmorkrgtkpjfi
ijnoronjkrrilhsf	omjhontppijjnqnt
srgnuiqjsiufqsur	infhphhfljnnjgmr
srgnmipjsiufusur	itflkglinkgtqtks
sgmjfpqrsfkfpnug	oqligtsrfigqijjg
sgmjnpprsfkftnug	ukotgfgkropuqnsh
toqfmhkfsprtmsli	iolfohglpupktlnh
toqfuhjfsprtisli	iojflokutppogpjr
mjofkohpqopkflfl	ftfokpihogjrlkut
mjofsoipqopkjlfl	sgkkglhkghqhpifn
nfpqspjlsqhmgjor	khmpfsoufqljsloo
nfpqkpklsqhmkjor	mrrghjunrkpnkloj
qloorigptintffjk	ssttqhlkjnknnukj
qloojifptintjfjk	unorfnkhlnrushtm
tkgmusroqkhqkiff	kspgulmlgorptjik
tkgmmssoqkhqgiff	gklfgsrsnouilhif
gurultfgttnpmfpi	grooolrfimorsfpg
guruttggttnpifpi	srspmshmqqgpgssh
jgjljqqissmmkrnf	nrfkiifujsggtikt
jgjlrqpissmmgrnf	rtionfnfgholktsq
pqphgnlqmqfqislq	sikfftggmtiqukkh
pqphonmqmqfqmslq	pujhgsjmsgmrglgn
ipsuoufkjrkqnjhp	rkrmhrnohsqqlmoh
ipsugugkjrkqrjhp	pkpqptqgqhgtnnug
gpiilphfriipjjmm	hrgjushighojjogf
gpiitpifriipfjmm	irmkojgismionhgp
pqkglifmpnqpfnns	thnshkthnpoljtqi
pqkgtigmpnqpjnns	pokqjntmqhsugirp
hsokqfptiqfuptfq	ogrfithrhnnsituk
hsokifqtiqfuttfq	mgfiufklpmpsskls
hhforupkqskutrsl	kqfnhgsjqpglmjoi
hhfojuqkqskuprsl	qmijgfojgffhsurp
onkintttmjtmpgit	jmkhogifptprsonu
onkiftutmjtmtgit	iqltjhnntktfljqf
rnjpnofsqunhknto	qpuksjkkkuorlkfr
rnjpfogsqunhgnto	filsgouqnlkpiqni
jrrtskrfplojkjts	jupkluijmirprkkr
jrrtkksfplojgjts	hstoinmnfjrnmukp
tfsstugofosllmju	urounmlrsktpsghf
tfsslufofoslhmju	tsmkmpspsqsifmon
lrpiurppmgnlltqu	ilmufhfupogqskqp
lrpimrqpmgnlhtqu	nuhjujsmqniriqjs
mtlpqutlffuiprms	rjiotnghrfmkpsgu
mtlpiuulffuitrms	uqqkuquqqpfkktlf
hgsrfiuiurpqfhnp	qpgpkohmptlgkjun
hgsrnitiurpqjhnp	htqjlrforijookhl
hlqqikjpjkklpqgs	snlhljffhqnjntjj
hlqqqkkpjkkltqgs	tgogqhlfushpuqlj
fhnmsjpigtfhrpth	ujliqrkpihgnqfhp
fhnmkjqigtfhnpth	mkohmgjnsqiiomhl
pqojpohilikqmrnp	rjpqmtnlrgrrgfmo
pqojhoiilikqirnp	juhtmpifjojnojou
nirfuoquimqhgqur	kfitohjinlpsrsqp
nirfmopuimqhkqur	rmpjqrpsmhlqrrjk
opksrhupopoqhiht	pjntgjgpspgmhsmt
opksjhtpopoqliht	tmostqtmotiriokq
gsmsjsugorufqrmn	gfrmonusoomstmph
gsmsrstgorufurmn	iprhupuqijfiqfgr
sqlpggfmrgtqmqif	gmfrmninpmqifgji
sqlpoggmrgtqiqif	nshkfmjluuijsklf
tliforggoqlsgqfj	npmlgpttfujpguhl
tlifgrfgoqlskqfj	nguugslfrgtlsogh
mggskirqnhohrqkm	tgjflmmkmhtlsptu
mggssisqnhohnqkm	hfrmflgkrghlkunu
ipoujgftpqlrukfu	mfttjjojimifstkt
ipourggtpqlrqkfu	gnohutqiilijjtpk
pthttllstnigukol	sfnslhhprmqtkmnr
pthtllmstnigqkol	sgjuqpirtnnojpjl
inqfgrpiqrgfhomn	kotkqmhqhjhsnjsp
inqforqiqrgflomn	jgmpsofgttrmrtfp
hlrfqputkinnsjih	jijigfojsnoftkmj
hlrfipttkinnojih	orsinlfgojjpjghr
truupqlkofqhoror	nrfmigqrihthpspt
truuhqmkofqhsror	qttpufsrsquurskj
gjfptslikugpimfs	uoigksoolhrjgglg
gjfplsmikugpmmfs	uolqtsqsqmrtsosl
gtiltkolffgnnqim	spksqhnpqmjtlqsi
gtillknlffgnrqim	gljngmgjpgpflolj
qjnsrklgsukfhgqn	mntnrtjjmfnnqgto
qjnsjkmgsukflgqn	mtrrojopujhpmklf
sfhlkutrfgrkmfnn	thophtnqljuqpkjk
sfhlsuurfgrkifnn	hiurliiqmosgiqsg
qnosftolqnfpsrfn	ssgkqunfigumknsq
qnosntnlqnfporfn	qmtptijjtfmmsgjs
ngpoikormmnsnmji	ofosntnmmliptglr
ngpoqknrmmnsrmji	pitssmoggouksoro
phofmjutfplhhhkn	qkigujohjrssnoom
phofujttfplhlhkn	upjuruqmnrkmjttk
iqihofpjtgtjhpsf	ifrtughiugjrkuuq
iqihgfqjtgtjlpsf	mgohngoqujsmtiiq
jfmkigtkmmqotokk	rnfhkrrkrhhgmtqh
jfmkqgukmmqopokk	fhmmtgimlqgusruo
olnsrjtkuuimgosf	tospufthmrklssru
olnsjjukuuimkosf	qpflutitnijqffkl
jtihgrufphuriqqm	osqqfkmlhlpkhskh
jtihortfphurmqqm	gojtgrpsrutrsumn
nsjgistmsonnhoqo	lhlsotqtqqkhmjqg
nsjgqsumsonnloqo	sgljtnjgfogrmukg
jstljjtqkjogitqp	qklsjklfsftkrulk
jstlrjuqkjogmtqp	mnppgjhigmopspgu
onjlslkspinrjrph	qfmjolkfmqujmslm
onjlkljspinrfrph	phuinmjrojhhhmhn
imnqiumfnklitmjf	nosrligkprihkulo
imnqqulfnklipmjf	frtuqqilpfgohjsm
pnpukhgmqophsnqp	puksnpngpiqujmog
pnpushfmqophonqp	hghhkhjihiotjmqt
ifqqmqsfhutqgpkf	fikstuhooljfgsps
ifqquqrfhutqkpkf	qmigqifmhpnipooq
qhpnlnigrnmtnlfj	hukjlilqfjjhjmgl
qhpntnhgrnmtrlfj	rgoulogtgsfimqhq
ghoisljqitujgppk	qhogijjfhhnurnpu
ghoiklkqitujkppk	qshmkhknhhkrtlpn
fqtirljhirpntgkn	nnhplqkfjklgssfl
fqtijlkhirpnpgkn	fuhtprisjmuhkrmq
rhgtfogkhkmsnhii	kmgnqipltslfoqmo
rhgtnofkhkmsrhii	jmpoihsmmufnhsnj
sruhnrmkmlqonhul	fqqmktlruqqurpoh
sruhfrlkmlqorhul	lisimrgskjllsgil
pomqkspshrjhoonn	omorglmjnuqgsipu
pomqssqshrjhsonn	jshtttgufltjklqm
qotmqgtgitmlhqsh	jqlgmtlkgforujfp
qotmigugitmllqsh	ruisgjotqrftgjnf
nhqsrllkjkgfgpoh	ptqqltpsnslktmtr
nhqsjlmkjkgfkpoh	kkspknjmjjkpprik
tsqhjjjirnqgjqlp	jhlhlihihfhnnjjp
tsqhrjkirnqgfqlp	siqfhlkmqnsoonkj
oukogpuoltsgrurm	hlnrohkpqnonlugg
oukooptoltsgnurm	kusnkgrkpiqnomsj
hioniogssitknstr	pjlglqsmigrksghq
hionqofssitkrstr	ftrkhiimumkrgjor
tqfuhrhkfqlukntp	oglinsrlqqitgkig
tqfuprikfqlugntp	fqpmjmuquthikptq
qiukglttgijpuhnp	nmmqlkoolkfrqhii
qiukolutgijpqhnp	upmrrnhmfuojufrq
gpfsoirunqimiljj	phftstfnmstffthr
gpfsgisunqimmljj	fffqtnqfkuqkhrtr
kqqjlinjkgmknkjg	fhuifklsuhomtjql
kqqjtiojkgmkrkjg	rirqipmqnjhoulmg
fjjtltqoitiqsuiq	gqnjkqqslkjfithp
fjjtttpoitiqouiq	jiotfltisjonupmu
frqlntknmsigjffh	hgfqqikkjkrpirlq
frqlftjnmsigfffh	utqqokmssljnirkt
gqhsnmlhhguuophf	fttrlisloiuqtifr
gqhsfmmhhguusphf	gptmohnnqgnfuklg
nkofrqpnnkmfpkhm	ijufjlmqkorpjpnj
nkofjqqnnkmftkhm	lrgilgstjimkpotq
sfqpjtptfkilfolh	mthotprfngnognns
sfqprtqtfkiljolh	mspflrlotnifuhmk
qgmjlqofngghkgsg	umpqtfsgsiogulso
qgmjtqnfngghggsg	rumgkptfouirrqkm
pnutnjggggtlusrn	tkjspfhrjtpspnjg
pnutfjfgggtlqsrn	rqhuipjhpiqrskhs
iiqgqktsftpnplpg	lqhthhshppiultqk
iiqgikusftpntlpg	hupljpptjfnrijkk
ojnfrgfjjtmjqhng	gfrkjnuphsuiknur
ojnfjggjjtmjuhng	knotpjfojlhhitmj
gmsnqgpsifmsuust	fqhktqftnfpujrih
gmsnigqsifmsqust	rtrmnqphnmkmrmlo
hqshsrpoohrnlfko	qjtiriorqurtsfih
hqshkrqoohrnhfko	pqsonpiqhtghqnop
shusgglfnnpupuqq	impmimkmgmtmpugk
shusogmfnnputuqq	ilhklhtjonqthrjs
nngjhifpkjsinmnn	qjfungnkmsijqljh
nngjpigpkjsirmnn	koonhqttqornopht
ifprmglonintmnnm	pghspsmlnqfkruhs
ifprugmonintinnm	hqqglhkofnjtqpfi
qsopfnoughgngihp	ostgkgtmmijjifsg
qsopnnnughgnkihp	hsfthpflgkmpggmg
toknqhrshnuorhos	hutkpnojnmphghqu
toknihsshnuonhos	fgktntgtnitrusmn
igmorttospnufhit	qtmngojjssfnlfjp
igmojtuospnujhit	ftumohflrnomtrip
rjnpiluuuhfqmgjk	hqqtufjfnhhkhofm
rjnpqltuuhfqigjk	smqnmgofojfhfgrn
ufthufnloppjikqk	fjpiotfsqgjolqhf
ufthmfoloppjmkqk	pnmnlstrsphmstqk
nmigtgqhkfplmmno	outghhiqughiurkm
nmiglgphkfplimno	fgqgnsgnpqippurk
stujuntluoulipuq	ujujjippoqfsroft
stujmnuluoulmpuq	rrjfnuiisrjtsusu
ufpijoourstrmgoh	spfqpnqtilfumggj
ufpironurstrigoh	ktitnspmqktqkjlj
ogfrhiisuhkmjiln	runrokkthgfgghff
ogfrpihsuhkmfiln	nfnpjnnomknqrnmm
jhiosnhrugjtnlnf	ofogqoikqqnurplk
jhioknirugjtrlnf	rughsnopuomfspsf
rllqllpqjoqsmphn	nrkohrqgofntilkl
rllqtlqqjoqsiphn	pospophholtpmgis
shurfrmpfnuorhgl	lghqoqthntrggmrh
shurnrlpfnuonhgl	ltlmfgghglnoruol
uuogkgrtjmfnjtpn	fugpnsipftforunm
uuogsgstjmfnftpn	gfsgfsshrfgrlshn
jsospjotoogstknq	lnhqnmqkhqmhtron
jsoshjntoogspknq	uirrjfjjptrliopr
pfqikmlpmioihhrk	nfgtkqtnsomfpksh
pfqismmpmioilhrk	tqfrinttilkfnnjl
lgkghkufsipmffpg	oprrpglkhnsrrhrr
lgkgpktfsipmjfpg	rsknpsjouokltupj
ispilktifrgfqttg	gpqrpnmisqnrggtk
ispitkuifrgfuttg	rhjjsglknnuturuk
glnoljmnffrujpql	sqjnmijhjnhmlllk
glnotjlnffrufpql	uhgnlghglnkikrlk
igirhjqssmkgqqkt	jfgqljrphhothstg
igirpjpssmkguqkt	isjrihhrihtfktgl
opjkhmplstlgfhfu	rlhtgjsipkigkfqp
opjkpmqlstlgjhfu	tikonhighmkpgtlp
iopfqkpmpjlssflq	pstrpnqgifqkhljm
iopfikqmpjlsoflq	otphkkhookuthjkp
pqghmopujntmknik	gnfojqijgmkpikir
pqghuoqujntmgnik	irlfrtltknkfgjfg
ghofkhoipiohghmp	rmlngfopnsjttoru
ghofshnipiohkhmp	ufmjjjqhugkqgrhp
lnujforponogopkg	ulpkpftlmtkrrkhm
lnujnosponogspkg	jhulkmjqtlshufst
mqulhlprpulfkrjr	fiohuphtllrussso
mqulplqrpulfgrjr	gkgnttkjoktkrjks
rjfqufttjtmrqkpg	sugfronjfnunkinr
rjfqmfutjtmrukpg	glummlngtikfnjll
pfsskufofpmsfmll	hmkqmnfmlhqmmotf
pfsssugofpmsjmll	klnrjshngpmohhrg
pkqfjujkprrmujph	otisfshtqokgnurl
pkqfrukkprrmqjph	nfuftumpsjjttnjn
hnrofplnqpqmqtgg	oqqgkunknklsfrmu
hnronpmnqpqmutgg	sfspjgpoufnhonoh
gkgtjjfluumtplmr	srtqushifsopohtl
gkgtrjgluumttlmr	jfjhfmqpmfohrrlk
plqjsnlfskqonnnu	tjmpnffgrjpkplmu
plqjknmfskqornnu	kllthkfphgglulni
kfkhjlpjfsgotfif	hkgsinjutsimnhhp
kfkhrlqjfsgopfif	trgklnplmnkoopjm