qnpjftqrrqggkhjl	trotqmspuptiontm
qnpfftqrrqogshkh	tjrnhgkosqhrmshu
jnkqkfuhumlsfnhl	gmijjopkmqmnlrsf
jnkukfuhumtsnnih	grrpnqqglgpinoup
irpuhoillrqsfriu	ptpmtikmlrosskof
irpqhoillrisnrhq	nlhotssqitoujksf
kphkitjhinulmjlr	lfmtlhfipgspjflu
kphgitjhinmlujmn	ffiosoourporgpsg
uufklsstfgslkkrm	tphjfpohttjstuun
uufglsstfgklsksi	thhfrlsrithtusmf
gnplhloslsqrmijp	muhsoukfqhihnmjg
gnphhloslsiruikt	pfqknggjqusfjrkk
gjugiojhptpkmqnj	joltnopummfjhgis
gjukiojhpthkuqof	jgtsulnmolmmtipj
nshqfitfsfpolkgr	ftuftgkmkrnnjglm
nshufitfsfhotkfn	tskpuhkiqpomhhnn
fjrssfpsnksthkng	tmjusjsjhnhnqfuq
fjrosfpsnkktpkok	smjriljsfmtithhp
kmltjgjskomurjkh	lljnusitqluhmiiq
kmlpjgjskouujjjl	purfmrthorplsoum
ljiprfilhikjjgil	prjspupkmqoomsfg
ljitrfilhisjrghh	jiqflqtjpmsnulrj
itmhgupfornntssr	gfmthrrgrftqorgu
itmlgupforfnlsrn	jiopilhptfniijsk
kffiropprjgotpmn	gjnffpnoqqnsoqgl
kffmropprjoolplr	tktksnjkksfnuoms
sfjisijigprtoqni	gpluitggjphtjqpn
sfjmsijigpjtgqom	ljknipjtnnknkssk
jtfntfpumkothfki	uknqkirugtpuhmki
jtfrtfpumkgtpfjm	mrtomhhsulroiuph
uhmfiiqrmgguqtnq	ifoknugkuohjqrhm
uhmjiiqrmgouitou	nkrqorlktolfgrno
qphlutufjsonmqqg	pjgpgfrurrmfmqlj
qphhutufjsgnuqpk	qsnlknujissjlofm
nrmmhsrtjqktntkr	ltonntihnmlhujpl
nrmihsrtjqstftjn	qolisuroogruhqou
ksjiqjiflhnruftr	mhusjtftoufhonhq
ksjmqjiflhfrmfun	hlutslofopsnqjup
rfhpquugulfssfpr	tjrokloruoqpjpmm
rfhtquugulnskfqn	fuqsnjqissnlkjnh
gigggtllrpfpqirn	fmguogpojjtstrhr
gigkgtllrpnpiisr	isikisunkjgoufjr
hmutspkpumnkisjg	nffstruhohuollqm
hmupspkpumfkqskk	ophtigrjfgfpspfk
hporjjqimkrsifuf	sfjursopqhntjijh
hponjjqimkjsqftj	orhontfhnhounknp
srpsqkfgomnqigtr	hgjuhollrungkomj
srpoqkfgomfqqgun	frkqqurmhrnqouku
isoirofotolthhmf	sssltpnqkgkhlgsp
isomrofotottphlj	osgsnumofgpnlour
qrgfpuqmmfgkspup	sljjrgjkprmpgokl
qrgjpuqmmfokkptt	jsnfltssrtmqnipi
nlottqlnhgnmfnfh	kukkrpikminhjglj
nloptqlnhgfmnngl	ukomuqjgipogflot
lotlplpkqhpnhkmg	qnqlimjurnfpmhkp
lothplpkqhhnpklk	qnpmktupgutpkqpl
gqpgmqruqiirknrt	niiosttumrqlkkuo
gqpkmqruqiqrsnsp	fsiqlpfmghlhfqsf
ttujuthfqrilmntk	phltfntljnolmmog
ttufuthfqrqlunug	otsqsqqgsfkigqio
otgqsuthhmkfgosr	olqplpmkktpkrhgp
otgusuthhmsfoorn	ltniojhnolfsunrh
kslhsmisfiiftqjh	johptlpkotirogkl
ksllsmisfiqflqkl	ipkiuptjtuginoih
sjrpninkjkpohljm	sghrnlsnqfrlrist
sjrtninkjkhoplki	srqftmqsknhqfqgm
tfuqhtpriqohkiii	sjntrkqnlrqptljt
tfuuhtpriqghsihm	fupnkgtfjksgkfot
qgogtjppqmoqsfti	tksrpgnrqlumpmpm
qgoktjppqmgqkfum	hugjiitktugolmtl
sifpigpmsjtugisu	fpgiiqjhmmlglgpm
siftigpmsjluoirq	iqjufrgrqkphmofg
stjrmsirkqfqqiff	ijrqnoqfjotfsfuu
stjnmsirkqnqiigj	qsrnufjiggitgsqu
psironkqrjokimjq	oprhsjqkmfjpjkrt
psinonkqrjgkqmku	lhjlphrrghrnrqlq
sjitfhgltqlokqlr	psohrfuftqfppomq
sjipfhgltqtosqmn	ggqnlhoispshsiii
lkokplluisrqnkij	snmifkuuqtgntuos
lkogplluisjqfkhf	fpfuotftlgokstmu
lnghfninliotsoqp	rqmimphtfhgkollp
lnglfninligtkopt	rjqilhjjkuhnmuop
jnpsrqupjuusgtfm	sogjhhkiplglgphn
jnporqupjumsotgi	lltggunquhmsokon
inpioitptjrlnhuu	ssfgfiqsimittlmo
inpmoitptjjlfhtq	olnsmlhjkhkupiik
kmkljfhjnttuhikm	mppoiqkolntfhujr
kmkhjfhjntlupiji	sjinsluqfunhimjg
kpfonftpqjtqitpm	ffmiknjipkkmhpkp
kpfsnftpqjlqqtqi	jhqtfjliknrtgiip
jgrufhkghqtgnmrk	ihplrgtskpnplmiq
jgrqfhkghqlgfmsg	nhhpumprnhoikifr
shtumisrjunskgli	ghrmfnknthtflqpp
shtqmisrjufssgmm	rmqjsfjkkskrkogk
thfktkigfmnigojj	oohfmnqolguktjil
thfgtkigfmfiookf	lpjnsnpjphnkgsln
rurktglofgfutitj	urfqugfkoihjfhkm
rurgtglofgnuliuf	lnlulgrjokjjgskf
snrrlfhrhhgnqrfl	ihnruprnikgusrgh
snrnlfhrhhonirgh	nksomtrqsprkpuip
gpnkifqrrsifnupn	umsnmjrinoipguru
gpngifqrrsqffuqr	omnlmsqsqmjnnhmi
srrtkrlloflsngos	nthtmlkkjmnmmkrs
srrpkrlloftsfgno	rrjqroltnshsglhf
qqhogfguhsjjiujp	kosqijjotmgfpsuf
qqhsgfguhsrjqukt	fomsthnfqjnissji
rfrqughfmgfukgnr	pkifugipjsopihmj
rfruughfmgnusgon	iknhnkjjhfihrmpu
ptkgguipsqkstngh	irrnusnsognppufg
ptkkguipsqsslnfl	tqfmtgfnnrusrris
isligilklfikqqul	sfponohukjggtpuj
islmgilklfqkiqth	potjhqsnjunrflpk
iqnjplimssurrimg	uuofoffilqqupoug
iqnfplimssmrjilk	hqufrpsqppkimjht
rpsgoqptggsolptg	ungghmnjtttomumq
rpskoqptggkotpuk	jstkqfhptqukmjqh
onjougqprsqkntul	jiqmknnfsntkppru
onjsugqprsikftth	lonfiqsqtfipklll
spjinsfhlputtfpk	uosmmgjhhqqmjrqm
spjmnsfhlpmtlfqg	gkutnfoosulskgkg
silkjqinjstktgji	pkjqqhrhunkkqpsl
silgjqinjslklgkm	fgngjjtntmgkpjhu
osnfjmshhfpmruur	jkigmgquligijmul
osnjjmshhfhmjutn	usqknpsmikissulf
fmjijgmnstpqpiri	itksqoosogljnfln
fmjmjgmnsthqhism	ghtsnhlffokkorrm
tmfiohmhhgsfutmq	qjlkrpiujmfshurl
tmfmohmhhgkfmtlu	omquppigjorhqpng
ornlskfnffsnkuqi	pgqiuskhmgkigipu
ornhskfnffknsupm	rnuirfglstlllsof
hplohpfmuplgssst	jphnuujjhhqlmtht
hplshpfmuptgksrp	mostlpnqmpifuokl
nirtfiugssmqfttg	nsotqqntkhtqiihk
nirpfiugssuqntuk	imjlkoqiuffqqsnr
lsspqjstjgnpntjt	tnropflmlphhjnqf
lsstqjstjgfpftkp	rgiotgkptqpfupml
prmghulmuohnqhrq	tmplnkgffogirqqh
prmkhulmuopnihsu	orjtphooplfjogil
khprmplpltqjnkfj	lhnsmmuttujhgggq
khpnmplpltijfkgf	prshrsojgslgkith
sisqhlgrtokpklto	ufimnmrjgfqpjtnu
sisuhlgrtospslus	kmfgjijrfgiitpuf
gfhhnpntputprnsj	lpjufljsmkpptkhf
gfhlnpntpulpjnrf	sgthgsnfthiistlf
sfhftnpsjqfgnolk	khsrfrkiphruhlql
sfhjtnpsjqngfomg	ihnhghhiofiuqfru
sqgkppsqoonrirlq	tgqjhhkhqlulrqjp
sqggppsqoofrqrmu	knhstjnssmjrtitq
krtfrimphkklgtut	fquthhpuprjupqhg
krtjrimphkslottp	fsrthfmfonpfosfj
pffurhljgllohrmo	jjtihnhpkqgufuuq
pffqrhljgltoprls	gngfssuqfkpsotuu
lhisphlghjnnokos	nmoqfijnhlkolnkq
lhiophlghjfngkno	oujtinknkiljhtor
tlglpohiifmkpqkl	jiootuthhglminfr
tlghpohiifukhqjh	trugjsmflpkuthqp
njhohksptugoosnt	mkflofpjgugjumnq
njhshksptuoogsop	fhosmkqifqkfqoik
pohqjkllhfgsttgn	tofrminisrrmnjpi
pohujkllhfosltfr	kofffmmmuiogiqtl
jlfiusqksmrotkip	nilfmlnupttittoo
jlfmusqksmjolkht	rurlpuolhlkjisqm
solouhsirmumsgru	hsiinkumttlgltqh
solsuhsirmmmkgsq	hihomoosugsrumoq
jftsjlnohhtstjfn	rrujuiojifimqhmf
jftojlnohhlsljgr	umjmqfsjptikiksn
tpgiotiqspqthrsu	rsjjpsuhngfrikks
tpgmotiqspitprrq	nlhsrhkrqginokrl
ssrunikrfgfpnkug	kusrmoqhhropftfp
ssrqnikrfgnpfktk	ihksnghoqsqqjsih
fmkfionttsupikss	ksigplmoplplpukt
fmkjionttsmpqkro	ffpfnjliittllqtn
jflqjnigkpskhfnn	ojtpohpqlptmlouf
jflujnigkpkkpfor	hfnqimnjksnrnllq
jluuqrkqltuurtrk	lomgnhuniqnnntjr
jluqqrkqltmujtsg	fjpttjtstmouirmq
sjmqinjusiissqsq	fqimnpttlotggrom
sjmuinjusiqskqru	llrpqnpiiuljmgru
fhtrfttmjolsntlt	uriqqmfhkmmlpoqn
fhtnfttmjotsftmp	gngmgtqkriprirhm
nkrrgpfnqqfmhmuh	jquurkpislnklqtp
nkrngpfnqqnmpmtl	gksflpjohlftlupj
ugkftkqpjttspgnt	mpjookhngrllrurg
ugkjtkqpjtlshgop	usomgrfftrkqpgto
gtnrlpkshlmiftss	mosipuoogijohtml
gtnnlpkshluintro	ffsknpruntpghfjm
pjruigurgsukpjjk	ostintnrqhrtuhsj
pjrqigurgsmkhjkg	ksumuitrrigtjluq
fmjohuflprjtpijj	mngpnmqfrpqkomon
fmjshuflprrthikf	olshunugsfiofjfj
rsfgktiolnullkhi	oqurikgglittuqhp
rsfkktiolnmltkim	mopkshmkjiksjghu
iohhohiqmftgilhl	fqhirnspsjmfprng
iohlohiqmflgqlih	ngoppfslpourpktm
thjspkfqhpjotjoh	ummqinphpqpptrkp
thjopkfqhproljnl	pjohuppsopiqgflp
qmpnqjrmslsoishr	hogmmpnmhmhrunjn
qmprqjrmslkoqsin	mhgpmrrgohhkgsnq
tljiiutkhimlgkps	ggktqljqissulsnj
tljmiutkhiulokqo	ilqfhqltfohtupli
sunstqimipkrgqrj	sjggrlugqfljghjn
sunotqimipsroqsf	spuijqmmhtsgsmmf
kukqfmfrmriominu	upffsoprrikinlls
kukufmfrmrqouioq	nsojjprghsjgppmo
hmnislfhjjqklrsf	qorrpkiuqpluijtu
hmnmslfhjjiktrrj	qiohsssfnpitoift
tpgmsqhuonjuqrfh	tomooiqsgnmlkrhr
tpgisqhuonruirgl	opprprtfsphsqtuu
gsftjshfujrspnqj	gnqrfnsqtnlumsjh
gsfpjshfujjshnpf	nnookffrtinhoijr
okintqmonljrjnli	mnkhlumjkjojtggj
okirtqmonlrrrnmm	rgltsgoisiomrujq
morlfrjpmmhlsgft	kmqftrrkihnjghpl
morhfrjpmmplkggp	gummjsfurrlfmsph
gpufolkgrrpsthrr	nrqrmkhhjnsoqhnk
gpujolkgrrhslhsn	qrssuogrtnrgqjkr
htrguslskomqplms	rnhhkljkgqqpmjrr
htrkuslskouqhllo	inquqlhokklshtqq
jsnuhpiuopiqggfl	sttgguqjglihhuho
jsnqhpiuopqqoggh	qurfjfpjsknlurss
grflopsnqqfgljmj	tnqrtrjngkonskns
grfhopsnqqngtjlf	gnptujmliijlrgfi
rufnsqihlhkjqifm	olrmfsmqnhlqqoli
rufrsqihlhsjiigi	rrhpggkntsfukmjt
tglinorniqshmgkt	gnupqfmkqpoghplt
tglmnorniqkhugjp	irgnjtokinnqmpsh
qnlgqmjumuistntg	smgtuuonfouqntpt
qnlkqmjumuqslnuk	rkshrjqroltlugno
torrsilqtklnkllu	qpprjqssljopqtug
tornsilqtktnslmq	lhsqqjrlpuusmmjq
hhhsitrjknorulom	igmfliqoklisjgit
hhhoitrjkngrmlni	lsohostknporhmst
uourptinqrqomrff	kijtfrqjohrmjqjr
uounptinqriourgj	jrumorqhnhgnipur
rpumfiusslotnkjs	somrqkmhrfuukfht
rpuifiusslgtfkko	hugfjftplhlmlgsj
gruqgtjsrkmukfqh	rrlgslmhrpqgpqun
gruugtjsrkuusfpl	sogigmrnikkmhisf
qnisklqgksfjrouo	jnqmrhqfrmpsnmjf
qnioklqgksnjjots	kflipmrnnhlkmktm
ggsolgphkplkntrh	initklnqnsonmtrt
ggsslgphkptkftsl	ffurhmhtsmtipfml
nrshmqmsrnjumuki	omlkkmhnusotmnfr
nrslmqmsrnruuujm	jlsiojnsjlfusths
shhjounjpkgmoqhh	pqijtmgupgqkpqsl
shhfounjpkomgqil	ullomrsnqgilstnp
rsisrnnhkuqshgnq	joosrfphfhitthpl
rsiornnhkuispgou	pkislhngguujrsim
upqugkfuqfsfqnng	fkhhtjqjtjrkqhfp
upqqgkfuqfkfinok	ljllhropohqjnsug
uoijtmmhnksjspku	hmqlqokggpkhmlkr
uoiftmmhnkkjkpjq	mnmkmqurkokrjhtn
pfqmnihjmgqtiopp	hukhsmfroglphuku
pfqinihjmgitqoqt	iprqlrhqulopuhom
omkoirrlfhtfqkpm	fhulrlquuspjjhpj
omksirrlfhlfikqi	thosslpohpkqkqjt
olturlqmfjsruulk	jokngmujiffgifmn
oltqrlqmfjkrmumg	siikqtnlojpphsil
nsshnsfkufmikqpg	ntqhmhjpolgmspik
nsslnsfkufuisqqk	jpmqhrhrptnnlljp
kufkltltshulskmj	sfiqnjnojmigfpkh
kufgltltshmlkklf	rolgnmjninoqouph
mtgkfkkknpkgrpiu	plhipnksfoufnjuk
mtggfkkknpsgjphq	kjjggthgsfjfjlpo
fqrggrnmrilrqsrk	frfpmphlotkluoqq
fqrkgrnmritrissg	mktgmooorjrhppqg
fkhqfonhusoufiti	msjqusqjjufihlpt
fkhufonhusgunium	tjppimkqpijufgnp
fmkpmsotrrhgpuor	tkngtsiootmglojk
fmktmsotrrpghunn	qijknimpsumkmknq
iuiphlmhqfqpfkrq	mhnpkumolqnkokml
iuithlmhqfipnksu	uuqkjpmkkgiquhmr
mhorsogumlnkjuur	oihgrssrutlirrqu
mhonsogumlfkrutn	urjhsghljkfomqhi
ionjkifkuifqjomo	nrrfjsfmjmjnoiur
ionfkifkuinqrols	pnknngrqqsgonqto
lfsqsqimnfojtfqp	rphrspjuplfhlkgi
lfsusqimnfgjlfpt	gorkiorjoitigqhj
rgqkkoprqlkitrui	uulflntkjmonqqok
rgqgkoprqlsilrtm	opqtfprmtmolutun
lgpkhsghqrjotoph	qkkmgqqhfnnruffn
lgpghsghqrroloql	hqpkhmrjtnfguhju
onulqottttjjonlu	njftjrjssnitlslh
onuhqottttrjgnmq	gfggiuhtpqhrfpot
hrsjqslngusigril	pqjgilkonsookjum
hrsfqslngukiorhh	riqkhtjtokmughkq
itlnnhklqkqgurfi	lgmmtqmluhqntjpk
itlrnhklqkigmrgm	rrhtjoufugttifgt
opofgnjjqfijffir	jmrnimmfmtmltrjj
opojgnjjqfqjnfhn	lmqogkpfqrsrlthh
rsqjkjlmtpmutksk	ofqgnrhrnqmfqnsu
rsqfkjlmtpuulkrg	ittkkfrhqslogflr
sjghnkrmlhgkjpfs	mguulppkokqmpmns
sjglnkrmlhokrpgo	ighlfioltlkqkgkj
jqkgqufmouqrpkgm	innnskiokripkpjg
jqkkqufmouirhkfi	jmjsfrrrhgsfuggk
iqhstskruojulfjl	ljmshpmpjnhpgjkj
iqhotskruorutfkh	ojsuqmglqspklksp
spfpjglninghmslf	msitmotmjkinfhmj
spftjglninohusmj	jjgtjfsliunonpro
orjsqhnkfofpfkfl	lurptoinqouqrpjs
orjoqhnkfonpnkgh	jstmlinsnlttpkif
qsjkpiukuppqihsu	llukouiggpmogotf
qsjgpiukuphqqhrq	sfinrotuhtmjpqkn
hmtmrrfhntlirshh	khpitutlpgkokugh
hmtirrfhnttijsil	klpfpgfniuskkski
rljssjmroqnqtsrh	mkotutmorpsknnin
rljosjmroqfqlssl	mhnlthfornjifuqi
totktmojljqftrmo	fjlnfgkjlfkjllgh
totgtmojljiflrls	gmutlijqprhnpkmj
jhpkgrugrtpiospo	tqukfgtkgiojrujn
jhpggrugrthigsqs	uunugnptmkuunugh
ptpjnjkfnkfoktqk	noqqqghupmjlrqrf
ptpfnjkfnknostpg	kijkskosmkrhgrhi
pnoiklktnrrhngfq	ltmmofmtoigomuss
pnomklktnrjhfggu	ismoofqjpsusojhl
quthqkufqrlkhgmh	snmokfkgounsmkss
qutlqkufqrtkpgll	tlgpngtqkrojgruh
sqjlrstjlkfsjrhh	mhotgqlpfrmsjkns
sqjhrstjlknsrril	osgrmhiomtjgjkkj
htufhinjtkkjssnk	tfhjnqkngjopgfsj
htujhinjtksjksog	gusummsofiosuloo
nsmugmpqigqspufu	jklrsilpnlqjppjg
nsmqgmpqigishugq	fnfrjlrorrloqksp
rroussohlojthpsm	qujjsijpjgjfkptn
rroqssohlortppri	htlmlkimsukhmflo
sjqpkitgsiinoirj	hirikplkksrqujfk
sjqtkitgsiqngisf	igqkgsrggtlrlrpf
ugrkqogpgttpfmim	hhlikpfsmpjmhsrh
ugrgqogpgtlpnmhi	jrgtmjnpogqknuki
pmrrotqkpfqitunl	mtjhusmtrilkplii
pmrnotqkpfiiluoh	jpsqfonsomoknpfk
mlphghtplqhpiilk	nftlhihihqignnir
mlplghtplqppqimg	kiqiksflutkgghki
gqpjnqonnjhtnotf	khhhqsnugtsukiqm
gqpfnqonnjptfouj	nrrsllmhkgsuhkun
lltinunftktkgnuu	itggqtlrikmpflks
lltmnunftklkontq	hunpitjtlkrkqjft
ifntjppjlmlofttq	fsiofhijflhnguff
ifnpjppjlmtontuu	mslkirsholqpsogk
ktoiujjkhlrfuuog	ouuhsqitqtofirmt
ktomujjkhljfmunk	psplghfrmhsnlpuu
kpiiitkokihppoqm	tmumgusmfppqrhfh
kpimitkokipphopi	punnrnrnsjjpiuhq
ktssqslslkhqgsqg	piikqqsiuiuggsgu
ktsoqslslkpqospk	lfrfolqupgmkkltf
mqlojgkoiloplgli	ijkhttmjfglohrrn
mqlsjgkoilgptgmm	nmfmhnouhfhttpns
thjuuqrftuiglguu	mquqkofitghhifku
thjquqrftuqgtgtq	grhrrmqrtgqpunqu
fstojrofquigonsk	opglpqtsoulngukh
fstsjrofquqggnrg	ktlkjijpmpjjqjos
qngfjlfjsttjfuhu	ktromotokmtlsopl
qngjjlfjstljnuiq	ofunjqupsrgopiun
mqnsjumumphtssul	klonrptqomklfini
mqnojumumpptksth	jfhimpooftmqmlit
hpqijonmsskljofg	lojgpsgpntgfjggj
hpqmjonmssslrogk	tmhuqsfjhhkojfgn
punoihfpjrjnprfq	iknogusmskmkflpm
punsihfpjrrnhrgu	pmnpuilfsplpfqmg
lqhmlrioqltnhknt	gunigrrmnmsqimrp
lqhilrioqllnpkop	ulhplkpofigflujk
triufjigphsfthnk	ufmsuoiptqrkoqnf
triqfjigphkflhog	slrkgrjnnkhqnloq
igqkojuuhhuhlmnt	kmrskssnkjkkthou
igqgojuuhhmhtmop	ouppguginmgrthul
gmghfrpsmqgkigst	ogsnhsmgjukpjugj
gmglfrpsmqokqgrp	uflftpomiotngqlp
iutouqljuhsokqhj	frotkijhithjpuum
iutsuqljuhkosqif	tjjojjrjjsqukotr
mnggkorjoprththm	opmopfinkjgingfo
mngkkorjopjtptii	hnnfhjjkskhsjngg
oklsjfffokpolnhh	ioohhustjoqtljio
oklojfffokhotnil	tkojilnoouoppnhg
khfitoomgmifggfs	mpnjuqkhuomjtffm
khfmtoomgmqfoggo	polpsqfuqmtimiik
imlqpnoosigrloum	jqtqrknmkhnrujnf
imlupnoosiortoti	fqgorrghgnfofoti
mruhtlgsnorotnph	sgtungqhltflhmrg
mrultlgsnojolnql	qogtrltsoojstrkj
thuoquqitkprmgin	fkiukmlptsjnmrgn
thusquqitkhrughr	hunutjngjlqmlqfk
ojshmsumuurkpifi	lnlrflkphnpsghgm
ojslmsumuujkhigm	tttkpirfmqrqrohu
lqrtffhqhhkhgmul	pttilnkuspumkkpm
lqrpffhqhhshomth	trphojhhnmhmlggf
mqsroomngusnjtfn	uokoktsgofntulrr
mqsnoomnguknrtgr	nomipnfgrfilrhmr
ifkuipqhflmiusrl	tfphrothjtlutkio
ifkqipqhfluimssh	tsoipnolhrotipng
jkngurholkqtqlkg	tnsulmfghlgqqlpf
jknkurholkitiljk	fuooulgkontmpgjl
tgflpsiquorilttk	mgpmhmthprurkgli
tgfhpsiquojittug	tttsinsnjuqntkip
giloqrftnjnihqpm	ohmhrgkuinjqjooj
gilsqrftnjfipqqi	ggkjtgufqsurjijn
fjnmfkpmugsjspnk	opohltfujsumfosl
fjnifkpmugkjkpog	unklphlggurmosho
rfkstpoljkhgmknq	jnurnqqsgpnusskf
rfkotpoljkpgukou	fiipluoirkfqtfns
sqplrolpsroqfsnj	rhikjuhurmufgupg
sqphrolpsrgqnsof	ghsruqmsoopgtuoh
ugshsrtkgtoronus	roqmutrolkqnjjqs
ugslsrtkgtgrgnto	rgsolqjtmglpolig
hqfrkimrlqsnlgfr	hulsoijopsrhiiuk
hqfnkimrlqkntggn	irqqjqjmllkumtmf
qmporujnhpurtuoi	pfiqsjlprukfsmku
qmpsrujnhpmrlunm	uqtmjrooiqrimqil
kfslfqtthgpruigo	hhlurfglgpjkutqn
kfshfqtthghrmifs	hlioilfrtsumjrjm
lllmghssigqtpomq	igpsikpjftgtsipg
lllighssigitholu	kptfilogrjmmmkok
ngmgfkkhitukuqhq	rthuiulutokpioht
ngmkfkkhitmkmqiu	jujfrngfkhgtfuip
ilonkuuitpjklggh	knjorusgptsrgopi
ilorkuuitprktgfl	opogmqogttrmqlhj
qoffjnilottrmjkh	nsooiotlogiopgms
qofjjnilotlrujjl	ptjirthurmugnuko
sonrgnknkonhrugi	goffnumukgulmjps
sonngnknkofhjufm	iurqotjuohiknhmg
gqhlinrqoslqpots	mokohguuqjtsjnnk
gqhhinrqostqhouo	ikrufghgiqlpimnr
sushlfkosglmufnk	ttumijmlfipgsthr
susllfkosgtmmfog	qtsgfslgkmgqoluh
pplqnmqugrltljum	qimfgomtqjrnlgjj
pplunmqugrtttjti	shlllhsirqtpgfur
ukthtpohspshllii	higtnkhktnqqllmk
uktltpohspkhtlhm	hoprjunpqkplgpfq
grjlkpqoijmtljkg	sumotqupkirmnltm
grjhkpqoijuttjjk	slupiiriotjsrmgl
rugssuouhhjltsji	mknuisiqmutnthmh
rugosuouhhrllskm	qonnrgjsismqmjrm
sftgnljojhntsrso	tfsflfngktuuplmh
sftknljojhftkrrs	fjfhoullurimfsnn
isioiutqlunkrfrf	hhshqpniqqtfjrni
isisiutqlufkjfsj	uoitmofjrlshjhoj
nlrrolhhsrishgih	uionusppiumgrrls
nlrnolhhsrqspghl	piohsormthihqqkm
qhkosujtomgrgonk	rslsgolihgtumprk
qhkssujtomorooog	gqtkfjrtjkuptmth
hmqslglujlkijkgq	nkpkhjnrmtmfflfl
hmqolglujlsirkfu	pjkupuonorspspfj
skqfquhrumghgjsu	qqmgnqkjnfoosjph
skqjquhrumohojrq	qgounfspgqutfhrj
iguhgskksjlprsnt	tjskitmtmoktqrlt
igulgskksjtpjsop	orpilrjnfmufpnsu
srsohopumlurugrq	rkiptguhmhnsfqgu
srsshopumlmrmgsu	soiljqkmkjlhpksp
htgipqlggqprunji	fkpsutjfptltrhit
htgmpqlggqhrmnkm	ujlsiqppoffngpfj
koqsipiflumgojpp	fklfknrskrgtftqs
koqoipifluuggjqt	gsmjrjitispqtnkt
unskpgqfokogjrmf	mkmrsstgumrouijo
unsgpgqfokggrrlj	ngpuflusupglirsf
phmlqhrrpgjmpnqh	htopjjjuhrkmrnmf
phmhqhrrpgrmhnpl	kgsojproqmpuuoug
mqofrqmnjqppmgll	pjfjpiokptgsftfq
mqojrqmnjqhpugmh	opptqsiuittpogqp
lnomfrmnrlngkllq	qkofoggphgofjoit
lnoifrmnrlfgslmu	tismkmliklftsiuk
mmnigtornfipsroq	tqfnnjkjprotrnio
mmnmgtornfqpkrnu	gnfjunlmlqgioqts
pifshjqfmsimqfpg	rljosghmfifkpnsp
pifohjqfmsqmifqk	rrpitukgjkmfsujh
mjjfnuunffrriqrq	ssikifhsnrssiiup
mjjjnuunffjrqqsu	lmkfrtotmguifplj
lfumhpfqohurgplp	khnkhsnfoopngnqr
lfuihpfqohmropmt	injqhglhrhitmqgl
rtmfjioimmuurojm	ntkkhlkgomtuoogk
rtmjjioimmmujoki	tmrnitpsmthnqsrj
sinpnhrgtllhhqij	jptmjqojomngkgrq
sintnhrgtlthpqhf	fjmngskgspmmhpgr
qlhtsnuuspfpkfuk	pimhtihhinipoqqr
qlhpsnuuspnpsftg	ghokktftfshigikr
hhnnkriptfhgiomr	mimggssotounofun
hhnrkriptfpgqoln	nsfglklmhgnugohk
fhopngtkfqtgiiog	unpmhrrogfpupirl
fhotngtkfqlgqink	mtflhunikitpfugs
usnfjuorklspjtgn	krpjipknuntrtgkn
usnjjuorklkprtfr	qjgnomknslssgutm
trggmtjinjnmhjpr	nimusmjhijrmqqjm
trgkmtjinjfmpjqn	pjqqpifimglfiifp
usquupohfhlmonuu	uuqohltmliqothmn
usqqupohfhtmgntq	hsfnqopsgopnshjq
simqmtripihfljpi	uujmhlktrspmkoko
simumtripipftjqm	ssukrujrhohgmuuj
fnffminripgglmpt	mpottissognujtih
fnfjminripogtmqp	llknkrjllqiojtof
spjjkuqfmglmftko	qpnotfmhfohroglo
spjfkuqfmgtmntjs	tohkshkirmgtotjh
njnlfkrrlkulopfu	koqftlplmghjpoft
njnhfkrrlkmlgpgq	ktqunfngfugslfos
thpmskfkrflqmpnk	tloprmropnfrhnpu
thpiskfkrftqupog	hnriltkmjokouhmu
psngtihsjisqmpql	srqspqufjhlkjjup
psnktihsjikqupph	mfhrphmntpojftll
tnpglskoqjkigttn	jiphfghjiuirrjqq
tnpklskoqjsiotur	jnhjrhfnhosfupks
prrtoktkjkugtrll	toqlttkorroufohi
prrpoktkjkmglrmh	gujtlrfjuotfrnqj
jhqosgljkphhpons	jqurgiikrgiqloki
jhqssgljkpphhooo	rsputkhhflgkrufh
rrtojjmuoqffgpqt	mtqhnskgnpgritsq
rrtsjjmuoqnfoppp	fgnhftjomtqhoonp
rrgssqjjqhoqokuo	mupgmtsfnmsqqmmh
rrgosqjjqhgqgkts	pouskuugkujlrmnq
ftmhfmktilmirhsi	pnptrilpgulsmrjq
ftmlfmktiluijhrm	jtkmqqpuhmlhufkj
ohjojinhmthgfkqk	uhjsjtltmlfqrkog
ohjsjinhmtpgnkpg	krmspshmfhfpspqg
onqgjtikthjmnfig	sjjppmoktjikhqmm
onqkjtikthrmffhk	piuuiopuupnujilg
fpngqugrihmilppm	jouploiqroofusnq
fpnkqugrihuitpqi	ormhkrmnougrugko
niqhrkfnjpptgmti	ufqqrppunmtuhrgk
niqlrkfnjphtomum	iilgngkoshffprgk
gurnimktmqopgtqs	hqspsgfhlfslgnok
gurrimktmqgpotpo	sqqnoqjqonpkmosf
ifpuipsfjktngmso	tkjgljghmplsgtgm
ifpqipsfjklnomrs	uhnfittgsurfmomr
ftlomfkghuhfhkul	oihhhrnkriqljruq
ftlsmfkghupfpkth	tiipufgtngjnjpsk
tfhghgfoijrtkful	uqqjqpolligolfoi
tfhkhgfoijjtsfth	tjntiffjtulrlnku
tfsrfkoftgnfhtmt	ntlmnjnlplnuoomq
tfsnfkoftgffptlp	oukkggoohiojrujk
nitkhiukosgtmgim	gngghfrnppfuggiu
nitghiukosotughi	lnqqmiilnmtskkot
mukhmsiimrhgljmn	ptfptptikkosktlf
muklmsiimrpgtjlr	kqmjlnsrtlgmsjlf
oumptmirnhqufurp	fjuoomqhrlojgosu
oumttmirnhiunust	ugpkuhljiqkjusgn
plliptitllurfqhf	fqotmfjugomlsspj
pllmptitllmrnqij	qkihsijtomhpqmkf
sphgjlnojufttisu	qnhrkppmumuhkrms
sphkjlnojuntlirq	mnhhrtmntftfsqgr
ukiilsfskttilogq	uhktfrouhnlfhhgj
ukimlsfsktlitofu	jmjotkkhinnrmrsg
pqjhrfnsltkktpqg	hrrguqnrsnqmmpsi
pqjlrfnsltsklppk	tglnrhhqhummljsp
hulkpuhiuhlhuihj	itppnshqkjllofpi
hulgpuhiuhthmiif	jiggnsmgfpogpkfp
lfrkmspjoghphpol	opjjolnosqgmgfqj
lfrgmspjogppppnh	gifjlfqlmhosugor
ptnmufqotkmifsoi	kpmpthfjjsiqnilf
ptniufqotkuinsnm	sinhukfrrmlrhgkq
rommgktufnhkskop	ouiotfnrkgijujqq
romigktufnpkkknt	kltklusqsjgkkiss
illuqmpkpstjutli	iitofjqsijpnutpp
illqqmpkpsljmtmm	ikfomohjjfmktfmh
qoqijgrijllfinon	ppqhrsnmtrhjflop
qoqmjgrijltfqnnr	gioogloirkljttpj
tqnhruntgkhpunuu	tkrqmjnummrnrnqu
tqnlruntgkppmntq	kfrqniunjhtpnjuu
uhrpnhoougmminpq	gsrmjukfruofqhfp
uhrtnhoougumqnqu	kjjirpoluqrkirjp
pkgjnrpnmttjutgi	jtiojliolmfrhtrk
pkgfnrpnmtljmtfm	ofntiiqoguoooplh
mntthmrfjpgihntt	gkhhtmnorrpnffii
mntphmrfjpoipnup	qkojojomuqimgglk
llsqnoonqnjlglkk	ogjkmrjusrkghust
llsunoonqnrloljg	tinntpoqqttmtomj
nukokosftrmkjjjl	lmjmksmsmrtinjtu
nukskosftrukrjkh	jrpjtrilrktlhnrh
glqhgqopfmhjnigg	usuqiujtqtrthroh
glqlgqopfmpjfifk	jfgqhnorompnptug
ningnkmjqpsrtsrn	hjngluoisoqspumj
ninknkmjqpkrlssr	mgnrslgrkikhkllj
ngtflkoosffstgsp	sumjqjsjilunojin
ngtjlkoosfnslgrt	nsnpgtfimpqqgrpq
otrguhujlugshkln	tkftrfigrksigosr
otrkuhujluospkmr	tnroknsrofsggopk
ljotihigufniofio	gklpsjpouiglsrpj
ljopihiguffigfhs	fiskjjlgsnjpiomg
nithluhgnnqfugju	rttkpioojkrqffhl
nitlluhgnnifmgkq	snqjtjpjshurjtfq
lgihnnkontmnsium	njsttqsulqfoupni
lgilnnkontunkiti	rkmgqhpjhlpkstoo
nmskrqltlsggqith	otjtmtnlrsqfsrps
nmsgrqltlsogiiul	hjinhnuthllptfrh
hupufrohnnfqofip	fummstkoisjngsqr
hupqfrohnnnqgfht	sqiggnmrfhujkmop
jskjjprghmuoonot	niffuojqgqrihnhk
jskfjprghmmognnp	llsuujfprfnqtspt
fnrmrgqpgkrhjpmu	mjonolfrthqnmjrj
fnrirgqpgkjhrplq	rohfptqkgsfqjpgr
hlqnhkkiiipsfpkh	qlsggmfsjrjmfrpp
hlqrhkkiiihsnpjl	ilfkkffplutgotfh
usmqrnijqtunfiqm	gmqruumjumqitiku
usmurnijqtmnnipi	iimkjufnifkmkpnu
rjltiqkkutmjoost	miohggfusphfmlgh
rjlpiqkkutujgorp	lqfnoihnusiklgjm
rnhkjgsmuisiqipu	uujhkhntujmonktq
rnhgjgsmuikiiiqq	tktmpkutpgsgouff
osoilkmokungghkr	tktmpkutpgsgouff
osomlkmokufgohjn	opqflklnqlssghij
grgtfuotouqkjhtn	rjrtjiunjngijnos
grgpfuotouikrhur	gsoqlhtupkoqshgg
ptgqsinugposmjnh	sttsplrfqkshprtl
ptgusinugpgsujol	jojnmukqgpshjijr
utunluqnjupksfsr	ujfthpqjopjjuqpm
uturluqnjuhkkfrn	qfhniuhgrrttsnmn
ftulrstpfnghrhml	mgokmmmijriqrmqt
ftuhrstpfnohjhlh	hhsppmffruhmkqtm
lrjiulokmumfjfjt	nlrfhqffkftrpkrm
lrjmulokmuufrfkp	optgqpnpnkohsfio
ngifpuskpfsggqpp	josfkhfhpgqlpgir
ngijpuskpfkgoqqt	rjntquimotffjpoi
lfmulpkjimljsllr	osruplitopjmmupp
lfmqlpkjimtjklmn	ptfpmniuljkqthrp
qpinosqnqqkqjjqr	ritgopquqqluptjn
qpirosqnqqsqrjpn	gfpsllttihrgmpnf
ogonmomrqojgkfgg	losfrllrrhruntpt
ogormomrqorgsffk	nipmgjnokqqihjkg
igtmilsukjktqlmm	hmtqqnhhjiqsfmjg
igtiilsukjstilli	hfjnosrmsltupohi
gqqmnguqngmrrlqm	guufnfrngroltnsl
gqqinguqngurjlpi	ktntohkfgnmnnlhu
slhtmgkpjsjjmsmf	ihqttskilpugouqq
slhpmgkpjsrjuslj	jrilrnufhurklqjs
onkmfrorlhfujgko	nslsojflukjojpkn
onkifrorlhnurgjs	lmtonkjthjkquitj
umuifurgigggmgfs	fjrhltootrkjspsr
umumfurgigoguggo	kfijiutotpiulglj
rlgjnungnggqrutl	rkokngisjmiggjsn
rlgfnungngoqjuuh	smshospogmutouti
hkooojgmrghtlnoh	jsojktkpnlufrtru
hkosojgmrgpttnnl	uhnnstrjnfkujjgn
nlmljjtrlqjqpkkh	linsuqruhmkgohij
nlmhjjtrlqrqhkjl	gjhkmsqlghnuujso
juujfqknjuioksup	ujpkntskgmmrmhrn
juuffqknjuqosstt	mftmkkslmslofotq
ppjqrgrfihnoiuik	gtoomilgrflihrlt
ppjurgrfihfoquhg	grrrssqtkustofut
toqtttutrfikoont	fjflpqguoprfloin
toqpttutrfqkgoop	gqsmqpuhmrmmlqnj
knsnrghrnkiunihl	gnthroqikkgnhgoh
knsrrghrnkqufiih	ikrlfqljqjmhfkjp
furfqklsqmjmurio	nlknmnqprqqussou
furjqklsqmrmmrhs	jpgiukqikjtrqmrn
lhngltlnqirspohu	omknfjjftnujqjpt
lhnkltlnqijshoiq	jfrskoqrqoqoqrut
utukhhrrpukkqpur	gjinkhsrgfmjktho
utughhrrpuskiptn	qfogmlggtripniuq
nukmqusjmrkgtkjk	qkjpnjskshthlrhq
nukiqusjmrsglkkg	trktoshmhnltgonq
nsqkojqkmrnnrurr	usmnpmkljtinooot
nsqgojqkmrfnjusn	snsiphptigirfprs
fujgsjrnntifijgp	kshsoggjglhltomt
fujksjrnntqfqjft	tsqkffnqnmqnrtgs
gmtimfohtttulhhi	qnqsqnprphnulqts
gmtmmfohttluthim	gossmikhrprqlsnt
ghftiglgfjoiigtr	npnqrpnufkfrljon
ghfpiglgfjgiqgun	sotrnisrmlgukiqu
isfiumquripnfuom	sfkrkmkjtfltqqqh
isfmumqurihnnuni	fofuoghphorsprnh
sfhikjnmjhuktpmo	fqkqsjglnitgmjrg
sfhmkjnmjhmklpls	propnphisijrgmgt
srgoqrkhutlihfsl	iggqpntpjilksjjp
srgsqrkhuttipfrh	ljlrmgkstsqtphnh
nmjflppqtntktuhu	oshshtpnnnppthso
nmjjlppqtnlkluiq	tgskhkomqfhjpphl
ijnpnsstiljfmjtf	jurhulfutptpuhgr
ijntnsstilrfujuj	fgigpgsksunjjlnf
pfghptmgtkstnnsg	ppoopfinjhsrjrmo
pfglptmgtkktfnrk	npinprpkphhrgpsk
ntsifknufrfmijrs	uuqjffqouuumjjgn
ntsmfknufrnmqjso	suutttmfqngulqtj
thjjsrufitjflnrl	kquthiqmuqspggnq
thjfsrufitrftnsh	ojlkfmqurfoupurg
quttfppnhppsngum	uptqqqouolmnujhi
qutpfppnhphsfgti	lsjjinfrnhtmiqql
hmfulhnluonrifom	fnpmgfrlqpgurots
hmfqlhnluofrqfni	ijigskunnorujlus
rslghlikrrgtjhso	imjspfnofkogrusj
rslkhlikrrotrhrs	fougmlgjrtmnimui
slqhqtoiogpfkltk	lgifntfkltlpmlhp
slqlqtoioghfslug	iiolkmkqrhfmnuft
nqijifgiitrghpqs	kgfgnnknotshnfts
nqififgiitjgpppo	mthrrnpqinulhlnn
glmjtjqimmjnnojg	hguhminnhuhpoirj
glmftjqimmrnfokk	pgfjutinkqqnhmup
hjjhmooumlhkqslr	siossmlqtussonjl
hjjlmooumlpkismn	kmjonjfsmlopjpjl
jqlrnqpopfinssff	hhtstrplkksnihtt
jqlnnqpopfqnksgj	suoktingpoptsjon
rkrotqqnuosopqqj	mlhlhfttntguntgq
rkrstqqnuokohqpf	nutffhnotrsijtur
gflokpuinujokqff	istosilhnlffhqki
gflskpuinurosqgj	lilhqpufhksssqpo
sitnkhsgsjomihsp	fnnqmnlhqmphoqks
sitrkhsgsjgmqhrt	mksnjjhjtlqntljm
lhrokhnnpiupqkqr	jslrpfghogujgrlt
lhrskhnnpimpikpn	nnrshlglupsnmuit
jukkqnlfluiuknqk	luorhmlnuuhpnthu
jukgqnlfluqusnpg	isffgrgngpshjtsi
ththqoskqqhqippo	kurrhnfhmforpnuq
thtlqoskqqpqqpqs	lltffishrfosoghj
guiftrjrphhinffs	rnkfrmgktlrmnnll
guijtrjrphpiffgo	ifonmfgkprmkmnul
rmgourqtsfkgfhlf	foinnkmtfjkfgtnt
rmgsurqtsfsgnhmj	hmfihkuhsnsqjmnj
nmoqufpngmlpgkpt	sopnjkusinnfgoot
nmouufpngmtpokqp	sjqjpsogpmfotnfi
mrsqogmkmqshosft	mrsqrfmjuinhqjnp
mrsuogmkmqkhgsgp	jlmikssrrlsjthog
jtmttfhruolrofuq	kmurupqllgmftfio
jtmptfhruotrgftu	okolhiumhsgjsglo
kggismquosiqfstm	oqrmktjmfqfnqmim
kggmsmquosqqnsui	qiuuftiojmuinouj
mpijnrjqgnujhjpu	irqmmrgglmhufjff
mpifnrjqgnmjpjqq	pmlkgithqpjiqfum
muitomjspqnlphto	kpqogrtonikoljhq
muipomjspqflhhus	iiimifqltrokpqgq
puqrkstnhjfugokk	kjjstnpotqghrjoi
puqnkstnhjnuoojg	klgsppopmjqqitgt
ipphkunslmqojpiu	siqgkstknpipjlkl
ipplkunslmiorphq	jsjumptnshoqimlh
npfonjgohmgsjtui	hrifnlrrikptrmpq
npfsnjgohmosrttm	otmosuhnoijtpftl
prfjqjkmjnhqliqi	ppilsojlhuftuuog
prffqjkmjnpqtipm	monnmltifqutluoh
mqqjljtflfuuofir	pstkfigjkonftupg
mqqfljtflfmugfhn	lfprnijjnuqoqqou
iuqjjhouprpfgskm	tomqqjkjmpmjllni
iuqfjhouprhfosji	gpfsjpjjntmlgjst
qslfktqlplstttil	tnutrfrfpmsfqnfo
qsljktqlplktlthh	ghppjhuopijlhjhu
jtlruhgpshnnrlhf	qsstiltronusumrt
jtlnuhgpshfnjlij	iustmhqltrkoimqh
pruupujjhpouuimi	ollirgmjrpjqinmh
pruqpujjhpgumilm	rtggmuthsrnffsrm
jnmptkmiiikmihpf	fmqgsmnksshjhjur
jnmttkmiiismqhqj	ulpuohnmrhqtmqto
hgnfijtjnrfssqtp	itinmqqtnufffgog
hgnjijtjnrnskqut	rhosoqgjgppsikkt
unopmsnjfgkkjnnn	jfpihomjqkkopkhl
unotmsnjfgskrnor	uhotiqnqiujulpjo
ghssllkprrugsknk	krptllqnpmpmjmmk
ghsollkprrmgkkog	lqoqlfrlmtjkrklq
nunkmmkhupmhkqgh	giqjhqkimjrkikhh
nungmmkhupuhsqfl	hrptpgojousimkpi
tutftgnnrjlgkots	tmpnppqohgoqrrmr
tutjtgnnrjtgsouo	qohustjltjjoqjuj
qrnmhfpuruuohrun	inngqqfknqgkjtjl
qrnihfpurumoprtr	ijhnjpmijpkulpuq
qtksmjrprsrmkogi	kssmmfjiqgtlqnfp
qtkomjrprsjmsofm	mhttsmnhpoprsrku
lmkgiktniquojkqk	tijkfjssnprqfujf
lmkkiktniqmorkpg	jmjgkjhmurmnnoum
kugpotikjmmmmnkh	jjjqjrigroqmjfof
kugtotikjmumunjl	gkslntmkigflmlok
mquohgfooqipnffh	mltfpmjlusjnkpso
mqushgfooqqpffgl	msmgrmjuntkhjnrn
fnnktsrnhintsosm	toosrrslusuiptkq
fnngtsrnhiftkori	qfgmqpsuklmhojmp
punjnnmigjuunjih	mokkukjpktpkoptn
punfnnmigjmufjhl	nigfippjltrrrqpj
qsmilgrthiiiuoro	onrtgjqfgrptnlts
qsmmlgrthiqimoss	nqunnlfflrjgnkpn
qoqtgjkmpqgitjhh	ospisrmkrlutfkqg
qoqpgjkmpqoiljil	gitoirpflgiftpii
siitrrpsgfnjjoou	kpinlgpltjujkjoo
siiprrpsgffjronq	ntlolsttmjoursoh
juuprgjhsrloohlk	kmhhliruisqguqmi
juutrgjhsrtoghmg	qqtqiimmgfssqijf
ohntummogothhshq	qmtpjlijkplkgsmn
ohnpummogolhpsiu	gtusglqjuiiftjoh
tqnsfksuoshposlr	nlinngofrilthslm
tqnofksuosppgsmn	qgusfsptltofgiiu
isujijfhguuohnqn	iinikhpgrqjgisti
isufijfhgumopnpr	kiilrlkjhrmffnmg
jqpjhllfhrsptish	lgklksgrgjjlshnk
jqpfhllfhrkplirl	mrlootuisjishsup
oihjsmuqnnsuuits	pqjlpjlmnjtrnqpm
oihfsmuqnnkumiuo	ipktplmrsiiujrfj
pqkqqtjmumonqhrg	konqiqsrlpjmrutp
pqkuqtjmumgnihsk	rqkfhftqrfkmthuu
gouqhopfmtnguujh	hpflumqimqskohjr
gouuhopfmtfgmukl	krrhpikgthkrqqtj
iilfgorkgiukrkgl	jlhotjllkkirilqo
iiljgorkgimkjkfh	khusrurqkfmslguu
urlsnugpqjmifufn	ftlgupptqhqhuphq
urlonugpqjuinugr	lpnnjhfqrighnugt
gprgpgqnrijurnum	lpqkkqtlgsgjjnig
gprkpgqnrirujnti	nkqmoghmiqfjhhrn
kplfgisjqsmkslmt	lrfjmufltogjslrk
kpljgisjqsukkllp	kmuftkliffrmlqoi
kqpkksljsujquupg	uslrnflstmutgono
kqpgksljsurqmuqk	jsjhonumknhipngq
sqrtqpjnullgmlgn	hnoomqrpniqngjsu
sqrpqpjnultgulfr	ngirluorhjrnomks
isggnrrpitjgjklk	sppjgujppnmijsil
isgknrrpitrgrkmg	hhllhfftklruljhj
ohptrtthhuikutrt	lqngpjthsrqunkkj
ohpprtthhuqkmtsp	qqmjuoimqilmkqmg
mhtpjpjgumigusin	jmuhuqjfjosrjugo
mhttjpjgumqgmshr	tjqhhuphsuhqmlku
qolpnoliflolmkhh	kmfmjflkuqtommii
qoltnoliflglukil	ukgptlgorkkkolhg
oktusuolljgunusi	inotiusjuikgnqlh
oktqsuolljoufurm	upfmkgtolojnkrss
kurfgngmlouqnhtr	frkurfnslfghgkrm
kurjgngmlomqfhun	kskpmlqohsrhhirn
tssgkkgjjqfkqjqj	uiuupqiisopqgulk
tsskkkgjjqnkijpf	tkhmpljluilujolt
gfstogrnghhspsro	moppijoirllqulgg
gfspogrnghpshsss	mmutthjiushrpokk
ijutnlhnllkihonm	ifgsmsflsnnofmnh
ijupnlhnllsipooi	gpgiksrkjgrhnfgs
mqflghpfttspnurt	lkrfpognhilomtot
mqfhghpfttkpfusp	rklojrmkthfmpsll
roofmthhojftrjsu	koqmslijiihtukmj
roojmthhojntjjrq	nsgkpikktkplnlji
iilrtogthmglnrug	llqmfhifkmolgitm
iilntogthmolfrtk	nuqmsjiuflsprpqj
mmonrjutlgrnlgsj	fkftfsfnrjmnppqs
mmorrjutlgjntgrf	oofngrrmjhjusmmu
nmhjppmnlfjkiggt	sjuqqongjkmhpjtf
nmhfppmnlfrkqgfp	kjotjippoqrrnssf
unlnnimhrnmimfhk	plhhkpsgjnjrmhnm
unlrnimhrnuiufig	olijonpilfjtnhtj
trtkngupppksfqrm	lkpgmqphlommrjmi
trtgngupppssnqsi	jonlmkipltnhjsui
qrsjfsotjqrumpug	skfflkssjplslhuq
qrsffsotjqjuuptk	jhhjufolftolilup
jtpkpnlsukrmihmm	ipslpgumsorpgtsp
jtpgpnlsukjmqhli	rolfolqrkununtoh
gnlugigmmkhjgmpi	ihfufhhmtomkfhfq
gnlqgigmmkpjomqm	nrlqghhhgqmuhksh
mshmhnhlkmgusmkm	jruolgqmmmuusftj
mshihnhlkmoukmji	kfnlstfnkligjnpr
spnfhksngukhutuh	iguoriknrhffunks
spnjhksngushmttl	qoftoijtqpqstmkn
kistoqptrsuiolsk	pnuiuhfltmpnqnmt
kispoqptrsmiglrg	gqkfhfksqsnurshr
mhrotnlfjqumhfuu	pqliqrrgqismjjmm
mhrstnlfjqmmpftq	ikqqqtotrmmojoip
fugijuushskopnfo	jpqunhiikqltpqug
fugmjuushssohngs	pplhphsflsgilugs
fqikgrrsortltksn	kngqkqlimnsfqron
fqiggrrsorlllkrr	nrjprjhsmumguonm
igqtoknftsionhsq	ukgjqfnjiggiipfl
igqpoknftsqofhru	gfnfstpikoiutsjr
rrsffgqpplnoikpf	rjttplojskorphkr
rrsjfgqpplfoqkqj	ghnkpptktpkjrfpi
gqnmkthptmptoqhm	fsljiikunolnmskp
gqnikthptmhtgqii	hfkgslrrrgqgrkot
mfjsunlktisnnrjo	plmlshpqopufllfm
mfjounlktiknfrks	snrtkhpgsroqtipo
nuuhtknkgjsgomgg	qofqtunnsqktfngi
nuultknkgjkggmfk	pfpngshfhmtfkkou
flfrotommjrrhujo	rshsshsmjukknfhj
flfnotommjjrpuks	ggrmporjnuiofnoj
gjpfottssrjotjfp	qlffguogmgqolhjg
gjpjottssrroljgt	qmoqllmijhiusjur
olninkpkorigpjjk	jopfnkntmhtkrorf
olnmnkpkorqghjkg	pomftqlmslignkto
lqlrtmorrtffjfqu	nlpslgsphrslmmmh
lqlntmorrtnfrfpq	hutqnjuuoftlgnmf
uosuhrfsrimfggjm	jhnrlosohoipjhrp
uosqhrfsriufogki	qtlrtrijmfrgtmqr
ppukflnpqoljkhko	sqnjlilssosiutku
ppugflnpqotjshjs	hjgulrlhgjfroont
mrfjsfqlsmflhgmq	ptmkjgirfhslskur
mrffsfqlsmnlpglu	kkmqftjgigogkrfp
gonllohpqpjqrrtu	jstlrjqnpsfloirh
gonhlohpqprqjruq	koiiqhjjmnptnufo
pnufjinimurmskmp	tnupjphfgqfirpgj
pnujjinimujmkklt	oumpoumfsilugotu
qtmolrtlsktmrqul	qspjptsntulthrfp
qtmslrtlsklmjqth	qgnkmphsullhsnou
kfipkknitlkissft	tflklplshglhlgik
kfitkknitlsiksgp	gsorlipfttifjgns
ljggulliupgofrpl	lkpqsflsrjmlqqrh
ljgkulliupoonrqh	sposrpfqfkqmlskp
islksfmikuhkqpmp	hhmffpnpmmptgrhs
islgsfmikupkiplt	nnlotfurisfujmks
mtrmpmhpfthothti	mtksfrqpokhkflsl
mtripmhpftpolhum	surtnspoppulfjgf
tkrgkrquglklqtus	flurkiksftohqkrq
tkrkkrquglslitto	smihrggqnfjsrsst
quikfhkmngjsuplg	iqlkqlhhitpjlurp
quigfhkmngrsmpmk	tqiiqufoslopofgk
lthkqrghopfkhnpo	ltmukulqlmmpsslt
lthgqrghopnkpnqs	khlirifglnoofqhs
uqknooisqijhhrpg	irmiisfrquukkmoh
uqkrooisqirhprqk	qihjqkontjurhqfh
uurkqppnpqgtntln	umjrnsmqpooqpmml
uurgqppnpqotftmr	ulklnjjrmfglhlhj
sqqpjlhjotjhunmq	oijojprmitklgihs
sqqtjlhjotrhmnlu	rnttsqjifkkmuhhk
rqrlmrohurphloul	lnunfhglkgrmupkg
rqrhmrohurhhtoth	ofppmlrtprghouon
msqtsgrkjfsspkif	tufghoqgnjtjtilm
msqpsgrkjfkshkhj	lnqfijjlonfrghnl
lunmnusfiunpoqss	kqunltfhimogiigs
luninusfiufpgqro	ouqtjgorrmnhrmft
fotusqtnrfjrortn	rfsulilqosliptpi
fotqsqtnrfrrgrur	josliunitiknhluq
pispjlfptluqfuug	iorgmmpjihohgkfo
pistjlfptlmqnutk	gigporufmsnlugru
nugklfijflsjoksf	iksooofmlttqmino
nugglfijflkjgkrj	oosrpmkmmkhqitrh
thjptmoqtfhiojts	lllgloqiifmrqffg
thjttmoqtfpigjuo	qqugqortnnprluls
sjqmroomskjgumqf	pqtlqjqpfopkponl
sjqiroomskrgmmpj	jptpgpoooggktrmf
ssktsqnnkflhmfpq	sqhkqtqsrthpnsmt
sskpsqnnkfthufqu	mkjfkrgrlmulmqko
mmopjfmoohlqirlp	mnhlgjpikoqjnjth
mmotjfmoohtqqrmt	sfmnitjntkfgqopi
pimkmlfjtqooorhi	qkorhthillqpifgn
pimgmlfjtqgogrim	kithmuftnmgqulgu
kqgsjrnhhfohrpfm	ghogkufsjsnguuth
kqgojrnhhfghjpgi	tmrijjogpnnooppj
mgrttjgnfrtlkifu	ojjhqksgotoojsnm
mgrptjgnfrllsigq	qrpnlttforruffru
mijthqjusjrkulfu	hplksinuqulhgmgh
mijphqjusjjkmlgq	mjtlljlnrkltmfjm
timtpmtnulntgglg	mofftprlqfqkppso
timppmtnulftogmk	tpmrrgfukkukjrhk
irpphmmjnkjuukti	tltflsiglrguuonn
irpthmmjnkrumkum	pjnlqsinrqgqhitm
jpgrsqlgmrrmttti	itukrstllppofini
jpgnsqlgmrjmltum	kftshtipfgiturpk
lkskhohrhtsoouum	otmtnnjhsjgtkufh
lksghohrhtkoguti	qirrrlipumkhnrom
pgijpqgunufjjilg	urggsggqmmhrlopg
pgifpqgununjrimk	llfppojhrfhomosk
mfslrormfsuiigqm	ofsujfglhkjknprg
mfshrormfsmiqgpi	ngumohkrqlppllut
pnlpmofmjilqlqoo	fstppngpopfgoorf
pnltmofmjitqtqns	jshuhjfsujguofik
ttjqgjkmlftgligr	mmntmrfolqkurrfi
ttjugjkmlflgtifn	ktoqikhnrfornijr
tgmflfuhofgjlmqs	tljnjoihhiirmpro
tgmjlfuhofojtmpo	ofqrsumofhkfsgmo
lqnkrostjnplfokn	srsnjrhfqimtjijj
lqngrostjnhlnojr	pttlnggojghmsnol
kkkmouqotmgplrii	kpgupnoksnoosiut
kkkiouqotmoptrhm	grihsqfkqkhlkkpk
tkkomstrqrptlims	ihkktmmsuopsohqu
tkksmstrqrhttilo	hfhqqgtkfslpllgl
slltjumrjfhutkqq	smmgnhougrkhotgt
sllpjumrjfpulkpu	isrnrhrsufpgssio
qqumrmusujoouotp	pkfjrngppurftlmh
qquirmusujgomout	pnsllgkiqqhqiosh
oqjqijshqgqjitlg	qojpokgohpmhkmuq
oqjuijshqgijqtmk	ohtmknnupfkflikk
plinsgfskklsgofi	oofsgmplsfnmuogn
plirsgfskktsoogm	nrflngtsqtsiitth
pqkgqoifnrniukgt	lokkrnormptjfluo
pqkkqoifnrfimkfp	njsisssltnshqjsi
ktrhqprklrhhrkun	khnntqhriqqkusqs
ktrlqprklrphjktr	gfmgrtppmpjjlmms
pnplonisiufhmooq	qkgfmotqnfiffsou
pnphonisiunhuonu	hsspsrlrprhkhofl
litoiqoiqjutirjs	qnsrrpqfiimustrj
litsiqoiqjmtqrko	jkromjkpsiuqgkpg
oqfnitunngitquli	fumtotoirmkmprtm
oqfritunngqtiumm	usjirtipofpjgjtn
uulkjimtrkqlkfnj	nnhrgfujmqgkkstf
uulgjimtrkilsfof	nplmfqqkropotoqm
qkfrkuqjghjrlnfi	hugmqnoiunkouqor
qkfnkuqjghrrtngm	ornqikufnihnsuop
itioiroorrmpfnno	sohipqisorpkqmjj
itisiroorrupnnos	imkljrgrkorllfhq
ftpripnnhitphljn	korqlomntjhgphhr
ftpnipnnhilpplkr	mfroullfjmuurusr
hpkonfplmsmhimsg	ugtmfphfsslrmgtq
hpksnfplmsuhqmrk	ufurrhgqfguhmpkp
inufflqpgkotqghg	oltqouiohmjlsujg
inujflqpgkgtigik	jhtuolgqmsuirmfl
tokgumlispirnuln	jhjkqujprmjhrhlq
tokkumlispqrfumr	stfpspgfgjnpuklh
luuhlgingjnigtnp	mjsjiufgmlnolmuh
luullgingjfiotot	nkpphsilhrooujrr
iktfkfhpoglljlmj	uptsfoormhikmrqr
iktjkfhpogtlrllf	rflngpiotopgmllu
ofnmqtijistmrlls	nmliporsuostmtst
ofniqtijislmjlmo	ffsffriukgtijfps
uqmrggknnkrtpufh	klgjljifhftmksmr
uqmnggknnkjthugl	ghrglqpisontrpsl
omhmlnqiqgtknsrp	fturtsmjoqnjqquo
omhilnqiqglkfsst	gforfmmoquqorpmn
tfprgmjjqrlqtgnr	lirthmtjgnjgptoo
tfpngmjjqrtqlgon	jsohhsotoqooufhs
uoknmmtrpuksqqoh	skstjthpplhnqnkh
uokrmmtrpussiqnl	pkitrsqmglpofuuj
htmnrkojtkkorlgs	gphqunqumruunoju
htmrrkojtksojlfo	kjknnlhiltlksnko
ngotfgsmsnshhnph	pmotpqkssfnmmhnp
ngopfgsmsnkhpnql	sqqtlkrmggmmgslq
sgrgntnjjuspupku	srsfrkgnfmkihkjh
sgrkntnjjukpmpjq	jhsqojmhokhgmifg
ifrnognrogjumkkn	oumoiporfngjtsns
ifrrognrogruukjr	stguflsqkojimgss
girtoouhfssghqku	mipuqgnifrkqmhpn
girpoouhfskgpqjq	tinkffourfmsjslu
sjmlnfuuqsuiilfs	iomorsjsfifkkqqq
sjmhnfuuqsmiqlgo	jsprmnlsujtjgrrg
lhtshkpnlnklffrt	jplufjfniillttsr
lhtohkpnlnslnfsp	fmnskimpnqosmsro
rssnnpshnkllonff	ukgplpfklujinftr
rssrnpshnktlgngj	qihlfqithojtsoiq
suonhrokksssijmp	rnfsiottnosuqknh
suorhrokksksqjlt	huggjotqqgufnnuj
mkfpogglospqlqjo	gjnjqpqkosjoftml
mkftoggloshqtqks	spmitiqrnqjirsjl
tolhfnqgjkphqnso	mpljohluutsuomfh
tollfnqgjkhhinrs	ulkhftonqkgqjhll
lhponmptsltnnrhr	tprrilqgrluffosr
lhpsnmptsllnfrin	lhgoggjknkgthlln
lgjojjiihrfmgpfk	pjrrsgkonrkhumjt
lgjsjjiihrnmopgg	stgrfllurfsjqqtm
hstfoiqnjthntgjp	luqssjmqgkhshung
hstjoiqnjtpnlgkt	lllhfrquiqktojur
riqhmfjjukuptjgu	prtnnlifhnpplnur
riqlmfjjukmpljfq	rikihfloglprltrj
mrtjtpmsuohmhfuq	qishgltsmsphhpkf
mrtftpmsuopmpftu	ohhfrhfmfkilnusl
nspsfjomoothrpst	lsutisjphffrkpii
nspofjomoolhjprp	slkfgnngjtosnijq
qjfnlsqloshhhlng	sgijnkhrmhfijiip
qjfrlsqlosphplok	gsnstqgppuskqtlq
prlhopjtqqofqpmm	mqmtooikkoufimis
prllopjtqqgfipli	tufiopkmptjgolsk
hlttkrslunjlhiki	oqijhifhprjjhljo
hltpkrslunrlpijm	skfmoftihrlstglm
psgoklsqirufqnjl	pirkukpsjrqhhmkf
psgsklsqirmfinkh	ggjiguijgiqhgsim
qrihsropjkrpmjps	ujgmsfliqknpnqnj
qrilsropjkjpujqo	gipsmimqfjqpkfji
qlugniqrglrjglih	mtphgoutjlnttlfr
qlukniqrgljjolhl	hqsutnnushlfujsh
qskgngpftgpsusjn	mfkjffpfsturptgj
qskkngpftghsmskr	tiujtitnmlrnhttt
mhlpnjounpughnkh	fsfffhqunmfkskhp
mhltnjounpmgpnjl	rghufmuqikospilp
gjljmtnsohpitfol	jqoikjsshnrkpsip
gjlfmtnsohhilfnh	kufsohpunmishssk
lrorsssljkormqmj	gnnmhsgmqqslliuu
lronsssljkgruqlf	mqhguikmnmjjiiou
ugmnuorjsioigguh	njfqpofpmrlhikrg
ugmruorjsigiogtl	osoknjrqpohissml
gurrpgjpqmmnmfip	kfrtqispktkkmoig
gurnpgjpqmunufht	thqqlprolqroporo
hlgmjhrnurnjlmqi	glskpghoruituipu
hlgijhrnurfjtmpm	qtmjqlropummrinn
mqokomgtnotgjull	nmmfigfhlqhgpjug
mqogomgtnolgrumh	grloqlihhtugjrgi
tfroujhomogkflqr	ijphllsglomijino
tfrsujhomooknlpn	kghthqrkhhlhqnog
iktfllurnjhmjfqk	itqgusnmtpqnlhof
iktjllurnjpmrfpg	kskrpllqnkpopqkp
hmjupptrfpttoqku	trikssptojgpqrhi
hmjqpptrfpltgqjq	krkiqsnfrlrjnpsp
hiqjmupfktnkjnin	ujiqpunhjqjqnogt
hiqfmupfktfkrnhr	irgoifsrmlhmsknf
rpjgnfpilmrjtfpo	kotugpfokmgrnptu
rpjknfpilmjjlfqs	tjprtmngmkmipnqp
oiqlkfsskogpshgu	kqsqpopoqlssjnhg
oiqhkfsskoopkhfq	rjikonjlkiglqnkk
tsmjnqmfhohnrhhp	rpisutlhlmqiihmu
tsmfnqmfhopnjhit	jrikrmkmhluiiphi
mgoufinjfmgmpfqt	kkiomslsiplsgsss
mgoqfinjfmomhfpp	ufjksrgksmlklpmp
rkhpgisgkhihgipq	olkupjmqrrgsskmg
rkhtgisgkhqhoiqu	grkjugskiisplprh
jfpfjkmhkutktrki	tkrjiunfqppnmmfr
jfpjjkmhkulklrjm	sfuifpuhphpoqlqq
gmifprtglsrjigft	gtflgfktsfgiuutn
gmijprtglsjjqggp	trihijpprfjnrljn
ptmijkjhpjsgmull	rstqjkptpjtohuqf
ptmmjkjhpjkguumh	kmoknjrsrkohnjqm
sflputkpimrotnhl	fugqggnjpuimmkls
sfltutkpimjolnih	gninqkiirgihmtlt
sfgqsomnsnkstumo	njfiltqitkrnifgh
sfgusomnsnssluls	tjqfshlgtkjlqguh
tsprtqgsqjqtmqum	suqnnlqksnlhugsr
tspntqgsqjituqti	mifptqhsoqfsnlgh
jpuismojqmfhnqsn	snlgnniiolfsionl
jpumsmojqmnhfqrr	gqojsmushusnsmqq
pklnkrtmjfimoous	shqiokornmgqumsg
pklrkrtmjfqmgoto	qtgphpqnukuqkigt
hfknijiinkiltqjm	rpjmspgkumsggkrq
hfkrijiinkqllqki	pjjjomsjmmuhfgkr
jffhoqumqjinmghk	kimntiotgiokhsms
jffloqumqjqnugig	htohoplrqhuqnggn
hhhgolqussqffsrg	nfqrioqgthsigqlj
hhhkolqussifnssk	uljlmqnlkghnkfur
riltmkgpgjlsiukh	ffhpmoltnluorhon
rilpmkgpgjtsqujl	kgrtqoftosposqjm
fsskpnmrohnouqoq	nnpotptikhngmsqm
fssgpnmrohfomqnu	jjouqrqquflhmnjl
lthnujqljkjkghml	pmnsloikopqhqrhu
lthrujqljkrkohlh	pslssfgmhlqhkprf
hnijlolkmmjflgpp	nqkrlgosommsqlqp
hniflolkmmrftgqt	jlfmjtnjhopiqnll
gjjifpnmukopiikj	hkllumifkoujglpf
gjjmfpnmukgpqijf	fkfqnsfmshmmujmh
okrriptupjigiiqh	luqlqorniutrqjut
okrniptupjqgqipl	gjrjhltiilurlmhs
nohljjoklplknkoq	jskqkkojroouoqpn
nohhjjoklptkfknu	tglnjqokrltpkmti
gooskshhijjqtptn	nshthjrtfhquhkqi
goookshhijrqlpur	ssjikfqgosoflrrs
glmhjqjittppnslg	tuloflmsonlmhiko
glmljqjitthpfsmk	nphgkumijintjlrj
hkposisqltjfgquo	iufposmuhtjoshhr
hkpssisqltrfoqts	hhssplhmjskpntpn
jsufnunklilpqgph	mtqfqktkhkjrgqpi
jsujnunklitpigql	pqlqtgsjtkumgmjl
grrpiojhuuglrotg	qsnnitguliprlqmg
grrtiojhuuoljouk	rmgumnfttlhjofpl
fhspqijrlhgskukg	uklknrkmroophqou
fhstqijrlhossujk	hfrsjpmrpnuokmup
gsgufqtjsmrpmgol	tkskngmqqqkupotm
gsgqfqtjsmjpugnh	lgoifkgornfkukor
slorthjkjgmhjmir	kmulnktfnlolihsu
slonthjkjguhrmhn	gontrjtkpjtghrqt
ujtqkqgqposrknqm	ssppsirqpimhljrp
ujtukqgqpokrsnpi	ooinogqhjipnkipq
npsqktlmosglnlsl	jloolfitmqontkfo
npsuktlmosolflrh	ojnsthnlfktfplrn
misosmopmfljknff	gngirlkookhukitq
misssmopmftjsngj	mkgggllnjklhgqul
nuqqglgjngsjjgnn	iimhgsnrtkquonks
nuquglgjngkjrgor	uhrrgfspouukqflq
lthhnshukqffgoqn	fmjqgtthisnhjpqs
lthlnshukqnfoopr	okgkgissoihsnnnp
qghksgjkfqgnkipl	rihftkrlqogpuhlh
qghgsgjkfqonsiqh	kiriprsoigluguts
oulriquqijpujpgf	srnpqtmhkumiughr
oulniquqijhurpfj	hqqlsrkmqmmiioii
sqpsujkupsirnuru	grtljuqffppmkljr
sqpoujkupsqrfusq	rqhirotnsnhrfiol
glkmkopofqunfghm	onoulrpolorusloq
glkikopofqmnngii	utggtkrrmffkrplu
njqsijjskffigllu	kimsunhrflhtltmi
njqoijjskfniolmq	ksnuioqoofkisrjh
qohtqhhsqunpmpqg	ooogjogihgrlmjpf
qohpqhhsqufpuppk	njfpngqpjltfkfgr
slprupinsfniipjf	pjomjfrqjhunksqg
slpnupinsffiqpkj	mnniplorojtsnkun
pqtjrfnunhoqhsfo	jmhrpiungkpmkmhn
pqtfrfnunhgqpsgs	jhhttrmjjqgqfgpq
sfjhjngqgfmfqpnn	pppmkhqtfppqsomk
sfjljngqgfufipor	ojnjsfqgllhimftg
rqutmjmljfonkqkm	tnflgugpggfgquht
rqupmjmljfgnsqji	ustlslhsqtmfrtrl
tsjhhjrqrjnpotsq	fituutkskjurkqsu
tsjlhjrqrjfpgtru	ksmtrtirjmstufko
rnutqphqfgqfouju	tmoofsfjftuhlqlq
rnupqphqfgifgukq	johppnhgmkhfihor
fsjhprhpnfqufktr	ojtpstojsrkjlhkn
fsjlprhpnfiunkun	ismmumkniuojlgqj
ounisnugsfmqgork	hotphigskihffuts
ounmsnugsfuqoosg	oqrifjhpqssosnrl
iglllfqomkgmqpqs	oujukmpjmpkqluql
iglhlfqomkomippo	somlhfpigoruuplg
quhmkltrthuogijm	pqhumtplkqnqlllk
quhikltrthmooiki	stllhqjhqqjmphnk
kllmhtmtmgmpttnf	hoomgolshsumstsn
kllihtmtmgupltoj	qjnrhhlijqjrotuu
rotuotggtupflukl	ljgokrgfutsonjhr
rotqotggtuhftujh	mimlukltjlfstisj
psrmjrquoliikpjh	klsgogtrojrpimhm
psrijrquolqispkl	grulknqrplskitqk
nunprjiskgnstfrn	pfuousggmfmpnhii
nuntrjiskgfslfsr	ngtmnqujlrrjtott
hqiqiujrlqnmgptj	lfgmkiurjfrumnhg
hqiuiujrlqfmopuf	olqignnrjrosqtql
qstrnsripqtgthjf	umqkstkkhhifgkhs
qstnnsripqlglhkj	pgupogflngnnlgtn
nsjoqouqtjriqhgt	skhtrrpiujmjmpmq
nsjsqouqtjjiihfp	igsssufmjrjqkius
fhmtfmmnootokjur	fmogpfhhuksqfhrf
fhmpfmmnoolosjtn	pfhguomoishmoikf
limrrmirrtsshnnn	rqslfjqpsqtmihfm
limnrmirrtkspnor	rofiklsjnohhnkur
furgiqjgjksjqptk	fgnlptnlftoshpjl
furkiqjgjkkjipug	kuinfuluqgmkgltl
trlqrnlsnmnhppnr	kuttfjiskgltsurp
trlurnlsnmfhhpon	rmfksshimmjsihkm
nskrskhujhiifhol	urnrjkunuufnuouq
nsknskhujhqinhnh	sgpfginopujufujh
tkflgmmtportlqkp	osmgjmhpkgnhrmpq
tkfhgmmtpojttqjt	rkhunlhmisspmtij
qnghjftssrjlmikm	fqfknjgqiinqnihj
qngljftssrrluiji	mthkupqkmngoppok
uglfkuqfsosgmrkf	sflkjgmnopgkmtnq
ugljkuqfsokgurjj	omqqngutsopmtufm
ilpnirmmuhkjflrj	nglpqphlgtkmqtrs
ilprirmmuhsjnlsf	plgnmiitnhtrtsfr
tmgijtthnkqgsqjj	plgupgllsphqfnhn
tmgmjtthnkigkqkf	ufruumjotslrhlnl
munmjuuhkqkpgfqi	huhssfjrmfqqfqmi
munijuuhkqspofpm	rijssskupstitgqs
hulntrsssinlsupk	njgtninnhnngmhou
hulrtrsssiflkuqg	onlputkkttufksoh
pqpjhjloqoljuplo	sqpstfkpfhqrkjos
pqpfhjloqotjmpms	mokrmlflnqonphjf
filjjfiptjispmrq	mokjipggignirost
filfjfiptjqshmsu	nlnuhpknpsmqifpf
sqiuhnltmujrqrnr	tgglnpggrttpkrfj
sqiqhnltmurriron	pnshingfrpmrloir
pjmmktjnmnqmilqn	sgiipggnijgmnmlp
pjmiktjnmnimqlpr	ruphkfglilsrrgqr
ihrsphplkiomhkit	muqtfufriskinjst
ihrophplkigmpkhp	nnkiflkkphsmirjk
jjjttftrftnuhmgt	mjjljgqqhjgjggti
jjjptftrftfupmfp	rmsglkgmqjhnnrto
qsmkifqqhirpojnn	kjfumpjsqpfjsfpo
qsmgifqqhijpgjor	ufinifnrjrljorol
koklngoirtjqmkrj	pktfsosroilujknl
kokhngoirtrquksf	tlfjtrtftnssghuu
gjgtultukoqijhkf	nosgqnffkfsrstgj
gjgpultukoiirhjj	fgfqmlmrtholpokf
nhjjrkgqogmpqijl	miphsggomoknmqqn
nhjfrkgqogupiikh	muusnlhrfrrtpgog
tkkjruimkqirjngi	htsgfjjifmtghril
tkkfruimkqqrrnfm	nrnnlmnoflgjjnfg
lkjfqkrfqgfjtujt	nouomfiphouqjuqn
lkjjqkrfqgnjlukp	ipufkrrgpllqfnoh
qnppqghkijgtpkfh	skjpnlnpisomuonh
qnptqghkijothkgl	kimkuqujpqgfstjq
uhntrjgrihipmtmu	nrgfskgmurmgsqio
uhnprjgrihqputlq	onqffhjqplqijuoh
injuppqhgithojnu	rkfqhtufpqrnskgh
injqppqhgilhgjoq	jqnoohkrpgnhkhmh
htqouhhnflosprsn	lhihlgqtknoqukjj
htqsuhhnflgshrrr	ijqjhnksmjluopij
umoqjnkpflgnqlir	sjfstfkunkghrsgo
umoujnkpflonilhn	pktpksoujfkiiqmt
jffkjnoqnnllgrtk	fnllifugufgismsu
jffgjnoqnntlorug	msgmtfkukmsumpnl
tpmqokfpmfluoqjq	rrkgouqinlmunfuq
tpmuokfpmftugqku	piffugptmonqjtnf
snpifptpuqgtkprk	sptquplurtkpiist
snpmfptpuqotspsg	qolrnfrnmuuituri
mrrulgtjnurhrhgp	ipptpmisqquomrrh
mrrqlgtjnujhjhft	rnkpurtktfqhlnut
rhnkjjtgsnjjtifq	jjpfupgkfophkomj
rhngjjtgsnrjligu	qkshkqmttnsquuhr
mqrtrjnpsmqfufjo	kigtrunmumlimflg
mqrprjnpsmifmfks	ilgjufoulrftthqk
hrqtrjrkliglllun	foussforopjfultg
hrqprjrklioltltr	qnqnuhugooukfqpm
nosljpinjtuhfjmq	ittrlpthjrkqljtn
noshjpinjtmhnjlu	suqtruijqflfmrro
npqnoltgoojkshlp	khhtllqiihffqlsp
npqroltgoorkkhmt	kqnmnlljinrnpopq
inlitoptutporfln	rpptjglhjfphnomr
inlmtoptuthojfmr	nksmgjgfkumfsjfk
tqqmnkohlqhgjfhs	phqmthiituosmplh
tqqinkohlqpgrfio	sthhujqjmjupjirg
kniuohhrolfrhssq	gmrgmhuuqlqgojrt
kniqohhrolnrpsru	fgioptqjpmsnkrsp
msjolsiqplqipsot	uonhfkokkhijhptt
msjslsiqpliihsnp	kortukttgfkipfjp
suulfhpokoqttsis	fhpouikhugkijfrk
suuhfhpokoitlsho	orhmlrskqinhjrmp
mqkrioppspgljqtl	mgkshirijltrlntl
mqknioppspolrquh	pgjslirnltmkqlkf
rgojoifihmjlohtn	fosrugkjkilmofkk
rgofoifihmrlghur	kkupgonitmripkqr
jhplkrjjthhghmnm	phhooojfuqqpnoop
jhphkrjjthpgpmoi	qhsqpnlknlgnmoig
ssnstlsolrfqrjmj	lopsirfpjgssufhg
ssnotlsolrnqjjlf	ktjfltpsmffggqri
tunplpiginkqmtpt	fflkuonfrsltpqmi
tuntlpiginsqutqp	rnhftsgpfhsghpln
hhjgfrjitulkssmj	pjjrmrspfrnpuptl
hhjkfrjitutkkslf	nokmgqqpfpfpoiih
pktoitfsontgftfo	lripssjkrpiukpfn
pktsitfsonlgntgs	jtiqomlijhhuprmg
oomjiihrkgkumguj	lrpupnhlomkguffl
oomfiihrkgsuugtf	tuinrlqqghknitun
jntklnighjspipos	pqhpinhkugkgsnkf
jntglnighjkpqpno	qnriqtlsslkmmrso
offgrluptjjmlguj	hhhjmfhmftgqknuo
offkrluptjrmtgtf	ttliuknfkkqlsmlk
giprstignsosrgnj	lsmoghjigphuoihp
gipnstignsgsjgof	hrgifsppshfogfnq
gskmtngjksiprfts	mhnmmjuufpjssnks
gskitngjksqpjfuo	itijtntutrguuhus
hgthutslopnkhugg	sjgpqjjsiorptiqo
hgtlutslopfkpufk	gqhlhtlfhltikmko
gugksjimqlmhgktm	rgljlguuhjoqkqrg
guggsjimqluhokui	fqnkglkuhikrokuh
snkkmfujpmfiggpl	qgtjugingsorfuqg
snkgmfujpmniogqh	gghjmujuttffqkmm
hftuqguigmqmntlu	mnpujkutfhqjlljr
hftqqguigmimftmq	oftmmkllkqhjfkkq
jjpglqjhukoggqfi	phqljmujftqofmjg
jjpklqjhukggoqgm	tlunppjigosnrrop
onirjgnkggusjhnm	jpguonjloijosqij
oninjgnkggmsrhoi	mfhhptjqilsfnsot
mpsfsukfjrmtknpn	ilgplglfsltiropg
mpsjsukfjrutsnqr	lggupmmjfquuokhq
gqukpufikjtpktio	honoilqpsopishog
gqugpufikjlpsths	gtioihjjrspnsgsr
gnqthuojiklmjttp	iifhmrttqqkoggsn
gnqphuojiktmrtut	trthqfhkstloplso
ulfrhggntttfgpfs	iqimphjmjfrfjnhl
ulfnhggnttlfopgo	qkrshlfoiguihtkq
noihgplopruhuroj	kmtntirnmsmjpqoi
noilgploprmhmrnf	qsnpoopmhpuuiosj
qgnjfomltimjghpq	jtgjtrsihklotttr
qgnffomltiujohqu	oigttqntfnnornin
isosprqrlqqfljip	oiuqfjrmtrtfhkuq
isooprqrlqiftjht	mmmgktlgumphsshh
rmtrlsnimmupimpg	hiqfrpstgrfihksm
rmtnlsnimmmpqmqk	rjhsktjtlkjqqpqp
ujqgttfghrutrogr	kmkjknoopnggtfjl
ujqkttfghrmtjofn	nqfiqfsmhijguoti
tnojjhnuukpirkki	krtkgrhftnniutrp
tnofjhnuukhijkjm	uhhfuponjtsnpnii
urhlstkumululqpr	rpikgrshjsojlkrn
urhhstkumututqqn	pimlspsfkgnonrhs
fpklmiumuhtljrtt	finkompfhqmmgljq
fpkhmiumuhllrrup	hftsrqpnuqphhhrt
iuqtitntskughomh	qltnimhlhlrkiopf
iuqpitntskmgpoll	ksgpotquqonmfsuh
lnqsnshlguhmjuhk	hgosusqrlrssjtih
lnqonshlgupmruig	tqgrfnoltsumhkpk
qoifmutiktnfnrig	fnftmrpimpjtriqh
qoijmutiktfffrhk	quqourojrtkkihki
fmgtisrpifigstlt	fuqnonrioolgpfis
fmgpisrpifqgktmp	tqlkolkkoitnfhsj
nlokmumuigfjshig	tughlnfjjmulmngl
nlogmumuignjkhhk	nksjfkntojmsnlip
oturtrimrjttllpt	ihohgnfturimhqnn
otuntrimrjlttlqp	krtpmplnmlppkouu
lqntutnpniupmrpr	qutjrijtnugkpfjq
lqnputnpnimpurqn	frhjtfsfooqprlks
llrqfliissklhlmu	osulsljqfrghssug
llrufliissslpllq	kspojrkrpjhuhkmu
mhqrguptluumkqfr	qhiolklpsjkhrppf
mhqnguptlummsqgn	oknijlpomnrofrlt
jhrokmspnjrhhoqg	nrtmmlggfihskmfg
jhrskmspnjjhpopk	tthmjfuirointpls
nllunllmtnukggus	rrsnqrhplsjuuuoq
nllqnllmtnmkogto	upsllfrtuhlkstsn
fqnumsntmoknrljo	nfttuhqtqtqfhjul
fqnqmsntmosnjlks	miorhfkgphukojjm
jmotsjkgrhrlhhmu	ingrgffknpfpmprn
jmopsjkgrhjlphlq	hnjmslgjofnpmfrt
thqpnnlnfjqptmmm	noksmqqttufminfm
thqtnnlnfjiplmli	hrkijutklprpkluk
jmmusinklrthjrms	jmhlkqqninkfoorm
jmmqsinklrlhrrlo	gnpgmmhkrnhpshsh
isusrkksiojognfl	lhtrjiorprlqrukq
isuorkksioroongh	kjhrjfurqsmiirko
ogrtgsijjfomhlkh	itnlqorpjpltsnjn
ogrpgsijjfgmpljl	fkjihfpsgssqosgs
giuiioqmlmkiikpq	gnrfthhpfqisupil
giumioqmlmsiqkqu	ofolrjkihmrsplgp
tgfmmmsqtptkijnf	shpgihqpnmuilsol
tgfimmsqtplkqjoj	qojofirilgifmpsh
ignmpmikiptglmmo	lnjmnspsifruqmpq
ignipmikiplgtmls	kkfpshlpsfrjstlu
unrpjmmmnntnijft	nltfmstmrsprhspg
unrtjmmmnnlnqjgp	oogqfkqurfnsqrns
ossqiiumhluomgfi	mmonkrgnmqrhgmom
ossuiiumhlmouggm	mkltkjoimsojgiur
lnjstriipknntjng	qfmfnpgfshhnsnfm
lnjotriipkfnljok	umkmtqgimiuijutn
jfhhrllgjhqniunf	jnljmhgjsrufmitm
jfhlrllgjhinquoj	qjijffqunmfnpjmn
knjootskhnlnkqgk	oomgiqqujpfspgqu
knjsotskhntnsqfg	pfhjifghsgqqhgmq
guqlphgsuiqjoqfm	fnuhkqqmgjtnpgpt
guqhphgsuiijgqgi	kslujormflstokjp
isninflslnhrhjmk	huluqmhftspotnfm
isnmnflslnprpjlg	rmklmuoiorknlmoq
igfqummfkhrrjltn	lgokkfqipmokkogr
igfuummfkhjrrlur	kornmqtogkujrijq
lrokmsqrjmjqthjm	himrmktkigkkopul
lrogmsqrjmrqlhki	sshknufjjftmgtof
jrqifhigrmtposjg	uptrsmhlngpjroor
jrqmfhigrmlpgskk	kjjttnnroiklhukj
othtmfrplktofstf	qgqpkmpgoouhofmt
othpmfrplklonsuj	tllgtsnqiutqtqot
hkpstqfnjsrsrgpu	pgqholpnkllhnuoo
hkpotqfnjsjsjgqq	qosmiutoifojnkoh
lklgkhusjkmingof	pmssupoomfiltlhj
lklkkhusjkuifgnj	uqtrkpfrqohmrkqh
gkgiunprqrjjltuj	rqttsoornpnrotiq
gkgmunprqrrjtttf	htsthmjuooqqholr
hqmmqtiptksquiuu	mjsqqlkoohugjhps
hqmiqtiptkkqmitq	qrmjtktkkjnsprlf
qotshltqmnqffjni	lhfnulnsmouupkjs
qotohltqmnifnjom	ollhuninthkonfno
jpmjkqsiisgtimng	qhtjrqjqomrgofgn
jpmfkqsiisotqmok	qpintkmsnnfiirjf
utoonfhgmtlfjtup	hqmjfprgtuupifqo
utosnfhgmttfrttt	rutokqnirifhquto
qughtjhukqotjltl	pgmqhiigsrgnstuq
qugltjhukqgtrluh	mghsjumqhrgpohpm
otniqkuqnhurrplj	jfuhhhjjojstpfur
otnmqkuqnhmrjpmf	rmiqolhkquofhgfu
smsgohmpujltfhqm	rqfifnhiumuqnrgm
smskohmpujttnhpi	umnqqfusofkfoulg
jkipnusiffliojkk	hfhrggmtkkpitokj
jkitnusifftigjjg	mhlopnrtsnfttlpm
mssortnignrslfsj	uirqpmkhmnhpujlk
msssrtnignjstfrf	lhhfghjqmqlnlupp
qitollmkhrokonpn	kfgjnrtrlfjgpouh
qitsllmkhrgkgnqr	lpmrmsmpgrqqsqsq
krlmujokssupirmn	iunrqfiifglripti
krliujokssmpqrlr	llulosishsjojijh
thrthmiknrnjoioo	hikpufhnquufltrq
thrphmiknrfjgins	jupnjmmfglmltfgh
jsgpltpsmfqgfkqk	strrlifsqmohumps
jsgtltpsmfignkpg	guhrjrijltnmgojh
gfiittqriljnrlgl	fqflootlhokkflig
gfimttqrilrnjlfh	knqqfojtjhmqlhqj
khrjghjmhtihsmmo	ntqittnpqpjpgoio
khrfghjmhtqhkmls	ngugqknrgsfhupjp
nshhpsqouupiirtk	ulkkuinsrgjljolg
nshlpsqouuhiqrug	ugrtjnhlrfskutht
qntkhhflilnmhqmj	mhhrosinufojkpll
qntghhflilfmpqlf	ipuffkispirfrulq
ttiuhhsqkgfmrknm	uqrgmjmllmhfikor
ttiqhhsqkgnmjkoi	jsrmjqiprgtgjuhs
rrhuuujfiiptuimm	ohrsqlghjqhjlrut
rrhquujfiihtmili	mnhtqhlgrrmorion
jplffqgkqrmkhlpg	hojugnpmspfplqkq
jpljfqgkqrukplqk	jtogqptojoijhjuu
snpnqqpnnnfkmrps	gossuhkmsqfmkujm
snprqqpnnnnkurqo	phqugqpompuuhqpp
pnpkphmlupphrmoj	ppqjmtfuoqfiqqoh
pnpgphmluphhjmnf	jffguqsflqrkisjk
smqhilljluppuloo	lurunontlnluqoor
smqlilljluhpmlns	tfpkiklomqflmktg
nphrklpghuokkrgq	initjqlqqnljlkio
nphnklpghugksrfu	lqjjllumjrptqrmr
itjnhummsinfrumr	jhitnjrsripkmgml
itjrhummsiffjuln	ljsilptnjgrktrhi
fqskhlluotjtokur	jktgghogflunggol
fqsghlluotrtgktn	fqtnukfusqmsgtms
gpsirguotsflfghu	iqoskjisnnpgkfgk
gpsmrguotsnlngiq	qiohmjqhkpmtgtom
tjkfgrmtumgujlnl	psjruntslunfqpro
tjkjgrmtumourloh	rstkqflmjptfkhkn
ofoiifoljnonshnq	rnnlgmuittrnufrh
ofomifoljngnkhou	hnquthonptgkplfr
umjulnmoosfuhjnu	trtkrpmfgtuipqfo
umjqlnmoosnupjoq	oqigntkfnqqnhtmp
pfjhisrjppnskhnr	mnkksjijqsomhtul
pfjlisrjppfsshon	ojltoofkmlqfismh
trgtknhftifgtipl	oikhkiiiijujkgqg
trgpknhftingliqh	rofsqkhfgsqtgotu
itjgkjknktffhfht	npihjtfimjplfgol
itjkkjknktnfpfip	unptpipjhulijgri
omriihumkpjiqgss	jjtloiipurqlritm
omrmihumkpriigro	ngsrmsqtuoinjhkl
litsjsuumsnikogg	pgmilpfsptghijio
litojsuumsfisofk	qlqtmjtsknfkrjlm
onloqoipqltuupgq	ojkosnmtpljnlqjn
onlsqoipqllumpfu	uioirilqfhuhqplq
ugqogtiifsumkfgj	nlklfnthfnggiors
ugqsgtiifsmmsfff	pfpojumnrpgkpgkn
plotuupoliiigkst	ifpqkpkiipfupkuo
plopuupoliqiokrp	rqhgmgnlqhguhqto
ttorlliisngjqpul	hmikhgittnpostfh
ttonlliisnojipth	gkjlmkgiqsfhhitt
pittomlpshmjfmgn	lmtsphpfnfofghqi
pitpomlpshujnmfr	pflffkffrippsjgh
quniqjklgmirkkqs	igltooftftjtulpl
qunmqjklgmqrskpo	snhkoqolhmphkffm
tsoqupqrmqtlukgf	mjgrtngstunfnpis
tsouupqrmqllmkfj	hhmjnjstosfurpkp
kkjkttssmnoqpkpf	ksihmnnfmrrntgkh
kkjgttssmngqhkqj	ftmfrniorftqurkg
ohngsnoukhqhgnnn	tjftrtmtjrhhqirp
ohnksnoukhihonor	gkiosnmnokqikmuj
gknqlphpslspglpj	ngtjqiqgilluiopt
gknulphpslkpolqf	mtpsqpompphgkhum
stknikmtghirkfhq	tjufhpiiplrgoifg
stkrikmtghqrsfiu	opmuuhjhsugsmnoh
fjisutllujuotmif	fgtfjmtposufosrg
fjioutllujmolmhj	fhfpmgqnktkofjoo
kjilmhfjuforpphi	uugsqgmgigfnjtrj
kjihmhfjufgrhpim	iotinnjmlhjupmli
lujtnmmhmmisrigu	qmsqolqfigslfosg
lujpnmmhmmqsjifq	hhukilofnsjlgktu
llmqnstkpkhnlnqu	qpoijjohnjjiguqi
llmunstkpkpntnpq	mglksjlhnghnmurq
ompprggftnosplkg	rjmnphoorfklpsms
omptrggftngshljk	stlfhrlpflpjotpp
jlopmpkplknsnklu	pfrksffknoqjnfon
jlotmpkplkfsfkmq	nrpqgmloiskoqprh
jlrpmsmqjujuisgl	njtithnugusjjujs
jlrtmsmqjuruqsfh	sngjjknkistrjfkr
ftspkpogtonuklgs	jgnkhupsrklojsuo
ftstkpogtofuslfo	ofpkmqkspmfpknfg
rmjorhojpiligkit	pfqkmotqfjgknojn
rmjsrhojpitiokhp	lpiqruqskfjlikps
fnfhstjhrrlrqsip	ojmtkstggnthlsqn
fnflstjhrrtrisht	nrmkfihjumjkthpq
lrskslfnhnpmfurh	ijhlulipjlulouih
lrsgslfnhnhmnusl	ojriluoifiplmslk
lolrhilmgknjsofq	gorupjtgohonmlgq
lolnhilmgkfjkogu	pjgnmfpjrtiotkqj
ssgjhsriitojlltu	omsjslinfioojiji
ssgfhsriitgjtluq	uqmsmmjqtqsinfpp
rmhuuiiqmroiqjqu	ujfukqgloutqnouk
rmhquiiqmrgiijpq	gfoolsgsgjuirjlr
hmrgisntjgqorutk	hntuooqtflqroflm
hmrkisntjgiojuug	qfqlggikhptgnnhg
iufrrrhfnqirtmgt	rkjmsigitpfknkpj
iufnrrhfnqqrlmfp	pqmlnfkgimilmifs
oiotmororgiprtlo	ikjmohfihujngigp
oiopmororgqpjtms	rnihfjpgsmjknrjh
srurpopktpuqnmmr	gfsgmlttnjffntts
srunpopktpmqfmln	fkuitfpfguhkoqjt
ojlmnrhsnosqmokj	ouphojtgunkmqfgh
ojlinrhsnokquojf	finlnplhfignimom
rhgnuotptsgplkjh	glmfqoorhkunnflf
rhgruotptsoptkkl	uktinqfllporftff
pishnjfomfkifumg	rohmnokifqoggorl
pislnjfomfsinulk	jjhtsrffssgfugup
tolstrjuhshntjoo	qrgtiikifttjqqgg
tolotrjuhspnljns	qfsoukrhojotuoqu
rlojfrjmqshuuuhr	hlujiqmjfijgkpsl
rloffrjmqspumuin	plquoiiihprfljmk
hfhnhmnltrplrofi	tghfnspgmrqshkrm
hfhrhmnltrhljogm	mkhpsusiqoijkhqj
jonklngokjtsuolo	olpoljurotikshtm
jonglngokjlsmoms	plrqomhngtmgjniu
uktlppfsklufsfsi	hmrhpkmsptusugmo
ukthppfsklmfkfrm	ullhfigmmkmnjoum
pfoomifmnomkumhq	qrohklsspfptflof
pfosmifmnoukmmiu	ujtpnuihuookoshk
hgonjomhhmfhkmkl	hhuknlohnjrrirok
hgorjomhhmnhsmjh	klrqtlmihrruoost
jjfjorirtknpsiqn	tgjumthjlkfplqtp
jjfforirtkfpkipr	rjiqkngjquikujlf
iljmhmjmoignlkfo	kgnnnsosrgkfnoph
iljihmjmoiontkgs	khfpsqoktmmsgjgu
gshjlsupfnkuppfq	koluhjpjqiiilogo
gshflsupfnsuhpgu	lqftsngumumiohit
loompojhoqljnnuh	hffogjighforntnu
looipojhoqtjfntl	lortlrshgilthmgh
tsupphiothmmmutj	nqfiltnntltfhugq
tsutphiothumuuuf	quhimsfrsiqqmpnl
usrisorjqushmpkm	johqmoqmoqpqjsfm
usrmsorjqukhupji	ouhmnijtnqtqgrrg
itumifmlnfmljfus	srqsfglssqffliin
ituiifmlnfulrfto	gfhlktogsoqsussq
olhnmjlnrfgtofrt	rnuoursolhgholki
olhrmjlnrfotgfsp	fooupmiskgmhiflg
iqolqshrinsfqjki	qipqmrouiulnorho
iqohqshrinkfijjm	kgkoouuhutnhfufr
stjhmijfftqhsmqq	uojmiqkqookhhuqq
stjlmijfftihkmpu	pjgsjkolqujsopsf
gjqgnuroprholpts	qfufkmtnpmtsmjuu
gjqknuroprpotpuo	jquglmfmgjqtklqf
sustqlilsgqjstph	qqnqpuufphfqksmh
suspqlilsgijktql	fggmunmhtpqhiikj
itjjjmiousktfnli	ufmolfrqntjoqgts
itjfjmiousstnnmm	lhtgolionoijsquh
rmrqjiktntkrufik	sphtmnrhfllsonhu
rmrujiktntsrmfhg	sninltslomljjhtl
hnlutqoskqkmmghr	trmnisuuqtnfooui
hnlqtqoskqsmugin	omutipnurgrgfqnl
ptsqglsurlsiprir	jttfsptmtjsmkflm
ptsuglsurlkihrhn	figstfspjtussmtf
hkistulhpnnughhj	irroggnkuhfsjsoo
hkiotulhpnfuohif	gtmrlomfirshjjsn
qkrppqsnqmslhjuh	uthsrhpqripsfhps
qkrtpqsnqmklpjtl	lhjrlsgshkjpfqup
rlpgfgjrufhffgms	nsfhiofpmpfupfpg
rlpkfgjrufpfnglo	gigqrlptquohnmnj
lugnlitljiquqjqg	mkiptminpjssrrns
lugrlitljiiuijpk	holosnukfosqogks
miulrumngpkmfmlh	ninsgqmhinifktmi
miuhrumngpsmnmml	qushfrutfnfquofr
hfhiplrhnppifqqf	gliojgtqppksnoqm
hfhmplrhnphinqpj	ksuqitpmsiokfunh
noijtfmokqlkprji	onpotfjiqqlmjomm
noiftfmokqtkhrkm	qrfsrushfhtqsmqm
gpqjrstipluhppsl	jqiptrunmijpfqpf
gpqfrstiplmhhprh	omqinjtrlpouthut
gthisgosiolrsupm	ophphpkpllrjimrp
gthmsgosiotrkuqi	iihqrfquqjqrnqtf
grjjstolrunruqnn	nfsfrfsispfoiskg
grjfstolrufrmqor	simtgqnqifkrulij
pfrqkfnqnjmtfigg	kqpqrsoljllsgigr
pfrukfnqnjutnifk	hkinriupqpqttoom
flmnqqiktlngmjik	giiljhitolfgjpfr
flmrqqiktlfgujhg	muqlqsirqujnhrhm
ugfpirhitsgjmuir	sljplnmluhmnhfnj
ugftirhitsojuuhn	lllpoqiuqpfpiutq
nfmmoqffomjhurql	pplmrruntnkltntt
nfmioqffomrhmrph	kpkhgfntohhunlnn
hjlsssmpngnfqktf	kupjquhfsotkmqkp
hjlossmpngffikuj	pjljkggkrlthlmoh
fiigusrlktmlrhon	iqqhtmorlppfhgtn
fiikusrlktuljhnr	hiojotqhsruqsgrl
hkutmuhpqmnjtutq	rkrnftqfmgtknmno
hkupmuhpqmfjluuu	uunpnqlmtsrftpmr
ijgjurssuphmijsh	tqfgpshsoqmufjkg
ijgfurssuppmqjrl	rgpgsnfolkgfjfqf
utplttluhpfgthor	hmismufqqunshnlg
utphttluhpnglhnn	loqjhrkjsfshpqfh
unqjniunqmqjmqqi	ilikfopfpnollift
unqfniunqmijuqpm	rukpngpohrgulqqg
sqoijifuhmmtqgjs	qnsqtsgikjoionlf
sqomjifuhmutigko	pmufpfmglqkfosfk
rsgqokhkqnttmkht	fnpruouqlrnoqrsh
rsguokhkqnltukip	kgrpnpqmqhgjspnp
itjlhltupgkqrlgi	osmughjmsiflfhgq
itjhhltupgsqjlfm	istujiokkjhpgqpg
nnikjlmkrnmslkrt	urhqhognmlnsrtmr
nnigjlmkrnustksp	njnhqiprnlsggkmr
mpghmhuprtoltijl	ghmqjsnpkkirnpfs
mpglmhuprtgllikh	qrkfjgtjjnrriflg
mmofmufnhhriiiro	nqoukfpnlikpruqt
mmojmufnhhjiqiss	lukhsnroqmfgtfln
pmnntqnmitqfuiss	rtpfffknjirrhjqf
pmnrtqnmitifmiro	fghopglhtnqgirjs
frihslqhgkpmnjpn	tpirnfqqrifnugio
frilslqhgkhmfjqr	iglrnlqpgusolrnr
uirpgunjkohirqpk	nmniuprkioujpuif
uirtgunjkopijqqg	gqrqfrhrkllmhmpn
kqquomurgmiripfn	ffsmihpjhsfgkrgf
kqqqomurgmqrqpgr	iihtqntgjmjitqnj
jhnptfktpghkggqg	qqqnnuiftsilhjoh
jhnttfktpgpkogpk	mhjutpshjfkoukgn
ohunsusqggihkofu	sshuqqfrkqisljfs
ohursusqggqhsogq	rmoihhqloknnuhlg
mkmjsrjfjhfgnsuf	qhghnjifpjrikhrn
mkmfsrjfjhngfstj	nkhgoqkopmjmmkms
mpqqhrfilsrrjrnf	pmliohjtuhurirmr
mpquhrfilsjrrroj	rkktlohkskijnhur
ikinfllrithpnprs	rkirjpmmnrlojthi
ikirfllritppfpso	pnkfkrrntntinqsm
kfonqpunnsohfjtg	mlkfuuhliokkrqgj
kforqpunnsghnjuk	iphskioujhqnfnnm
tthrugtprkfjrioj	grshfpgritphgprk
tthnugtprknjjinf	lijkqmuoflsftqhp
jhpomokguhhtorlg	pqtiorpgjhlmlfut
jhpsmokguhptgrmk	ghmojnhrrgtqisih
ptgkjtjokmpjsiff	ifpgnlogqijkrnhl
ptggjtjokmhjkigj	mosumhpshhosnulm
ttrhkumthqtpfgsp	qtfhkonfujrqhqpn
ttrlkumthqlpngrt	rhfntlfkpqmjrrlh
tjqkhstpkmtrmjus	gurgllpiurlmqjpi
tjqghstpkmlrujto	phlqhkkgjthnhpis
rlgpoftjfngmsioj	qlulqrskkgtitnjf
rlgtoftjfnomkinf	jihsurtgjhirlopq
fpnkgpitsnqnhtqs	igqlrtntihmonoso
fpnggpitsninptpo	oogmhtpurgttfqkp
pnhtnutgoimofghr	ttpsqrjflrsjfsuu
pnhpnutgoiuongin	hqmsfkistoskjfri
mohjptjigtliighg	gpnkforoffjhllio
mohfptjigttiqgik	kipfnltuuuiqhmur
ipiisnhpugmnsriu	ijsiksmhgosopqqm
ipimsnhpugunkrhq	uojssjjhsmkjfujp
prumsmjfjgqoonhs	ukgqttqojtjqjgto
pruismjfjgiognio	ngjshslhstunfjug
nrotohjgrfohnffg	husoumkgjhssroto
nropohjgrfghffgk	sstipqsiruhujgjg
ushsttsktlfpjrqf	hkprjouugtrrlgir
ushottsktlnprrpj	trfjtlogpmphmumi
rmhghjssksimkrii	npsironglqsigoju
rmhkhjssksqmsrhm	rjtnmphijifurujf
qqmltflkrmfnfifl	plhtqmufrjgmhjtk
qqmhtflkrmnnnigh	ljikquussjhmttnf
utpfrrmttluislqh	hglponsjnttuskfn
utpjrrmttlmiklpl	nuqusriotoroqfms
htkmgrflqoujplhm	ffoopljouhqkiumf
htkigrflqomjhlii	lpgiptusgutqglpm
tmfoksttnginsglh	rmkhhqopnmjpoffh
tmfsksttngqnkgml	jksfhrtqlrlompns
toroflipshsmlhlm	psrhpnqlrjfoiuiu
torsflipshkmthmi	thlmlnliqqunfiro
jrjhsopintfhmqgr	ifipqsqfuujkipnu
jrjlsopintnhuqfn	gofpnqrftnfnsnlr
frpmkgsgofuhskpg	qlrummkgfplolkns
frpikgsgofmhkkqk	qjnisotitfhhqmqj
kjlpppmrofhrounq	lghrsimiilhjkssr
kjltppmrofprguou	mlqtoojftmstmkgm
kpjhjplkjjulousg	kijfmhfpmqoklhpi
kpjljplkjjmlgurk	poursjigimjplslg
gljtstjmmqjottrl	hfpfqiofrtjlifnq
gljpstjmmqroltsh	qpspuhqhtstpsppg
litohsossstulsmk	fstrikgnstlourjn
litshsossslutslg	qlmgupurtmrfikjk
kusiuurssuqiooti	frqtptthkssifkpl
kusmuurssuiigoum	qjrguukhmqjspofs
ongrkgrpsnutiiog	lflhssksrsjtrhil
ongnkgrpsnmtqink	hfrrqtfifkhmpunm
sttinsjtnktrjqku	joriqnnlhigolrnh
sttmnsjtnklrrqjq	mioitspjqnqgfnmt
gjsjnluoqghhpjjr	fkfgftqfthssgfsn
gjsfnluoqgphhjkn	sonjhpjtqkhtmglu
qtosornnmutginrl	npjihkgutqpprisg
qtooornnmulgqnsh	pqgmhkjfsufjgluo
iiigugumufnoqmph	kljmghpmnioptonq
iiikugumuffoimql	pqqhufonifsfmijf
rfssngiumoijfhog	grppqsiknjknloko
rfsongiumoqjnhnk	omnsugrftnplkhkk
fosojrrfmokqjtgn	kufsuuqhfsjrknnq
fossjrrfmosqrtfr	glqfonmintituutn
sujgnmltmlmlnomq	qmjgorulhnpuuuti
sujknmltmlulfolu	phkkhhmhmnfhkifl
krutohgnfpfsikpq	qqqtssfpqufihpjr
krupohgnfpnsqkqu	tihnfjmsjlgmlpkn
jquqgutgptpmrooo	mulkmpuispnjqhmi
jquugutgpthmjons	fsuhggologqnfujl
fgpsntgiqtmfmqlh	jkfrrgjqummshfnh
fgpontgiqtufuqml	jhnnjlgkqippotug
fjhmuhhjmquqsqlu	nfitrojuuungoojk
fjhiuhhjmqmqkqmq	hknpfhtlkpjugprh
nkthnsqpgilirroj	pnoggputjmgjnjts
nktlnsqpgitijrnf	kmqtotnqgmnogmqq
mnkogugksikifurk	ikjlhnlfqhoiqquo
mnksgugksisinusg	loosptfpslpjhkhn
kkqunrqrlrunfpqf	usnrftnhojtqslqj
kkqqnrqrlrmnnppj	iukjjghrhrkrkiqn
kosmlnrkpornhkok	lgotiinofmoomkjo
kosilnrkpojnpkng	nkisjmmomkqjlojq
hofitimhjungqnhg	guullhmthrlhguns
hofmtimhjufginik	inuplspufmpmmluk
uplsgjtrtqlpgqnu	kpnguurllqfpkrip
uplogjtrtqtpoqoq	hprlfhijorqgnhrg
lnupruqfhfouphgn	uqirjqtsufhmppkf
lnutruqfhfguhhfr	mugllnolhpqugpff
hqtkpskrgfukghto	pgjkkgtkmshrqttu
hqtgpskrgfmkohus	uqpkiulrtmntrmnp
osqmhqpuqpjuhmoq	qinipfnusqmilqii
osqihqpuqprupmnu	gphtpolnmholkppj
ujggsrsuujrpgoff	osrmfikuhpfjgmmk
ujgksrsuujjpoogj	qojgomomrrnirutn
knusrspknoqslsoj	knomlolmmkqporfu
knuorspknoistsnf	pqffsmimirunhnsk
pfmtqntiqtqqmqjm	iopqjgrmrqqqpmls
pfmpqntiqtiquqki	oqgijjssoqfiimft
pgotkujhhiikffqt	fohpmjjfrfognjgp
pgopkujhhiqknfpp	sgkpurkksstrokmh
lmjtkklniqhooksl	qrufkhksuummnhrj
lmjpkklniqpogkrh	nulrjikoohjlkpur
itkqhrgnqlipkors	ogkfomspmjtpktgq
itkuhrgnqlqpsoso	milpjtrlgujlitli
rlgolnkmpirgsfqf	jqnjllligihpqnmk
rlgslnkmpijgkfpj	qtpsrughllitjhms
uufqhkghotpmthru	jiqrrulhsjnkuuip
uufuhkghothmlhsq	ukholmptpjpiiffs
sosrgrmfmpsiqgpn	quqfiufupnfkrrmf
sosngrmfmpkiigqr	jfftuspifruqjglp
uhkgurufohtrfpho	sqstmrfsjjnjstmn
uhkkurufohlrnpis	nrnlfqsmqtkunqgm
lkrmhtonjpskrkpj	mnkshtllfgjfmsho
lkrihtonjpkkjkqf	ppjkholruhsofmun
hipotnrtoojqofqn	ppsnmfhllukqsutj
hipstnrtoorqgfpr	tsiuihksinihksof
rhsgkrhpfmipntgr	sgnpkjkgijgjjqlf
rhskkrhpfmqpftfn	ilqqjgtmphhjrmsn
limnromutupsfjlp	qpsnfursjnnmuqjt
limrromutuhsnjmt	phunjkstluqnqlhl
ophfuhtfqtrigpts	rjkhhtssgfjkogff
ophjuhtfqtjiopuo	gpmksrjulgkrspos
ngjloqlftrtotrol	kskrkhqumummkhqs
ngjhoqlftrlolrnh	slmfnlgpmuoifngf
rpnphjtsjkgqiuok	lklkshjirrjrrtgk
rpnthjtsjkoqqung	qmulghmrgohtukou
rihhfqjirjlrglht	hgrofhqumhtrghoq
rihlfqjirjtrolip	kqgsnohmogikhuis
nmfnftjjmimmggmf	gfsfnjsmjihstkoi
nmfrftjjmiumoglj	krpqlnstuhrlgusf
rknoiultoofjjnfh	jjkjfsrftsijuglh
rknsiultoonjrngl	rttmimofgpggpsmt
olgpurqooskprunq	ogkkrshhjssjhpmq
olgturqoosspjuou	mhsrpflfkliifnkg
gonqpnhulfjomkmr	qghkshrhmofhnmhp
gonupnhulfroukln	jturuihljlfinhin
rlsjuqihrmoksojl	ghqlfhsphlupsogk
rlsfuqihrmgkkokh	rmqpgjrngmuunsut
tqhitfhqtkjhgtnt	ktijnoikikqppkpg
tqhmtfhqtkrhotop	okgufhpsqgthttni
jgfjrmjnfrgjtqou	sorumugkqfuugimq
jgffrmjnfrojlqnq	uqusmrfgrutnrqrl
ljjufpmgfqgfnsmn	uslhofktqpsulhmt
ljjqfpmgfqoffslr	rqkigjopniopkoim
qsngginfqgoppsfr	fnmqmttnooksliri
qsnkginfqggphsgn	hpqmgjpofpljjprr
jrtonsijlkjfitsq	lfimpjinusqjnnts
jrtsnsijlkrfqtru	iqlhtuhuqrklrkio
gmluuimponutfhtp	ulnklqolufgugoio
gmlquimponmtnhut	fmijmqhfukokqlql
gffnngjotqtufgkt	rpjosjjnphutruli
gffrngjotqlungjp	lrhiihfkoqrsmfqo
giphqsrhisoglhkj	lfqolonkiggjgmgu
giplqsrhisggthjf	ktppgjtsisfghqmo
qsilikhojjmgppki	mlkunoqrkfsklnkm
qsihikhojjughpjm	kisoljftssfpijgu
lulsfiunmfjkoihm	tnstgfrhfnnjntrh
lulofiunmfrkgiii	qsihsnnspsfnrfkj
jknpnqfshqngkrur	mgkjjjfuqrufqkmr
jkntnqfshqfgsrtn	kfsqofnottrlrgpl
pmtrponmttnktlhh	pslmmsggrsnhqqil
pmtnponmttfkllil	ihjirqsnthrgthlu
nlgluuhmhttokjfo	phlfpfuihtglooun
nlghuuhmhtlosjgs	junootitkousopql
mfqppqrgtklitmgq	mtssphikqkkfiiuf
mfqtpqrgtktilmfu	fplmummlfpuhfkhu
sfropiijmnrtsnpq	miijsuuqsuglnhkq
sfrspiijmnjtknqu	ofughppulsolnsuh
nikmlfnugfqqospp	frklujnqtufinnsm
nikilfnugfiqgsqt	olfjtoknhflitplt
nmsoipkkuipfhkgn	psihhiojkuhmhimt
nmssipkkuihfpkfr	mfngsitkmljssisj
mpqhhpslgljkrjff	ttohopolnqqnntpl
mpqlhpslglrkjjgj	mpsniikltlpnjlou
gojuhmqlofnnisru	kkutnmoilkkniium
gojqhmqloffnqssq	uuiqtqhkktutnomm
mjgmghgjjqguhmkj	itujptttqlogknuq
mjgighgjjqoupmjf	prqutmpnltlqhntl
tlqtktonnrtmlufp	kkrjkjsmsunppfng
tlqpktonnrlmtugt	pgptnjmursstufrs
fnlgrmilnmkjqigh	nhktfogogmrqskmm
fnlkrmilnmsjiifl	qugnqfgjsgjnqipt
rmunihnptifptglj	sfkkgtnnilossjnj
rmurihnptinplgmf	jiorosrjrmnhgufp
molhsnpstnpnfqij	lmknqngnqiksulio
mollsnpstnhnnqhf	gsntghhrsuiruiio
kitfsimqgngmfgli	lqqnuqftnfhripso
kitjsimqgnomngmm	piqqustqisrfnqll
nkrrtlulriipqsiu	figgoflnffhusfir
nkrntlulriqpishq	orsjoklqmfffsujf
mpnpoujlismrinpf	ujfpkmtoukqitgjm
mpntoujlisurqnqj	psmulkhrrgqmlumn
frimgtqnfntigkpg	ukjuglrgokoofgqn
friigtqnfnliokqk	sioufnrgomlrgpmg
tkfprqjqplpopouq	pomtorqsjntjusqn
tkftrqjqplhohotu	stpfujqhhuptljns
lnujfltgimsshulu	mnljtffgotqjkmqs
lnuffltgimkspumq	htssmijppjsjlgug
fiorojkfjulsrgnp	korfphjnlqklggun
fionojkfjutsjgot	hjhlpkllhfsuptii
mttqjoqmqjfrfmqs	qnhuqosfmuuigngs
mttujoqmqjnrnmpo	qhktighsonguolku
pnrklqmjuinlrptu	pqnqgfqimpmqnuji
pnrglqmjuifljpuq	pthpurquhuhtmrnm
jssppumpnmspomop	ihsurihqrntlrjio
jsstpumpnmkpgmnt	ujkolkqkpqrqlnqj
sqfjjltgrppqngmj	gigofkqtnqothhgk
sqffjltgrphqfglf	hnqpqslqooktnqpp
ruipfothtosiufsk	llikullikqmuoqnk
ruitfothtokimfrg	nmhkhhtfollsqkll
llnfsfkstpsumrrp	lnljmkkuuimqjffr
llnjsfkstpkuurst	kpuqqghihohnjtfr
njqnnqtonoqrrphs	sqipuklltiqrphhq
njqrnqtonoirjpio	nffhkguknoippgil
lpmkprupiqlilhff	lflglolhuqgrfiqg
lpmgprupiqtithgj	urirmigimsohmupr
fsrsiqhprjjprmgi	ufoofmqkfupuhigo
fsroiqhprjrpjmfm	msohklnjfnmrmutk
qnikgqikstihjioo	nssskmimmttnqkjj
qniggqikstqhrins	tmmktnmgsofhnkus
kltjjqngkfiirmnm	uqqlnoqoguqsnfij
kltfjqngkfqijmoi	phfhruujntojprup
tmfkrrfjqhhmjoif	sqqkgpksrlitkggt
tmfgrrfjqhpmrohj	nkjnlhslfonimgkp
hkuthtprlgrjlksj	kgqrinlslnioohgs
hkuphtprlgjjtkrf	upikrkrqhkifhmrr
plmngmlhtiujhuss	sftlmrppprtipqsh
plmrgmlhtimjpuro	ffqjkssgiuofumur
foqlmjspmuulloml	mrrqrpkhpiournsn
foqhmjspmumltolh	sqpkoomhshfipjlp
grrkkqjpoonjnklg	phihmpupjoproqsl
grrgkqjpoofjfkmk	grnmilkilggksjpk
lgpkrhjognjtguqr	qpiqqplpnujsgqqt
lgpgrhjognrtoupn	jsrghulrgflupglm
ougkhljgkqptfkru	qhuonirjphglgutp
ougghljgkqhtnksq	tukifrpkslonmkqj
tfrptksjquqflrhm	tqksnhjggofnpkqk
tfrttksjquiftrii	shmmtnripiggqggn
upkusoptffphithl	mttpqjuupupkruhj
upkqsoptffhhqtih	guopfuuhmqrhmmus
suigilqkqkmmjnmj	pgjujinufiqlkqkj
suikilqkqkumrnlf	hlponisuinssrmmf
qfjkmpskjggtsgff	folrftusimjrftfp
qfjgmpskjgotkggj	guksllsptltjhfqu
qspkitnjpktksirj	sprnntoigghkhgkl
qspgitnjpklkkisf	ifkkqmjrjtlksltu
hgoogjoifptrqhrl	qfotojopktohftio
hgosgjoifplrihsh	qmphisgoglomlmsk
joquojrmjjnhfoli	fmgiplqhrifqjtjp
joqqojrmjjfhnomm	fnsnlhrtrhssgpmj
uttnsoprpjkrhong	gpiffsfiqusphmum
uttrsoprpjsrpook	qsmfksftmfhkrsqf
hgnrhrnnrhgmufsg	pmisffmllfrhohjr
hgnnhrnnrhommfrk	jtuigjtjnshumsgn
qmusmfhkgrjknihu	ugmpifqnlljjupkj
qmuomfhkgrrkfiiq	stuiguplqttkjiir
pnnpknptmokhnpsq	hkhqhjtnfouitjsu
pnntknptmoshfpru	lfkktnimjqngmqng
tnrhfjqftpjjjrii	tnsjfmfujospnmok
tnrlfjqftprjrrhm	fnllphoigtmskhpg
krjnopgslpirnftg	pupthpkuorlipuhj
krjropgslpqrffuk	sgmqlifoqfrtoquh
tnhtftitjlgistmf	rlqhijsmpjpsqspf
tnhpftitjloiktlj	fihqfnihouhphitp
htpihqsqllpgsmko	tihfmphrsfqiotur
htpmhqsqllhgkmjs	knunmpipfuoiksnu
tsgsglpffqpiujof	hfuipipusmhtjgqn
tsgoglpffqhimjnj	nioofqukjhuosrot
mhhtikfhpmumkuqr	sfissfruijtjolsi
mhhpikfhpmmmsupn	ruiofmsqnljshmjq
gtjpjsohsfojhlfs	fjfmipqjnjttlllj
gtjtjsohsfgjplgo	sfkpqjknuklslmis
kpkpfspoguunggsg	oqknkkjtsmonffff
kpktfspogumnogrk	jsngrthfoqfthhhk
linogpgrsthmfkhr	poimoukpmjjmphsp
linsgpgrstpmnkin	gjuukogkthsutsqs
tiifpjrtluninhjk	fspnqqqliutmjnjs
tiijpjrtlufifhkg	tjhgpthfurhqqqkn
rtogngnmjllotkoi	jpilutkjhuitossl
rtokngnmjltolknm	gukooopqgpftooli
rfiumuikoktgqquk	kigfrsfjmlnntjkh
rfiqmuikoklgiqtg	tishotojjkoshulp
juojorprogpiuohl	pumoqqqsouorqkku
juoforproghimoih	ttsuhoukhskmoflu
mfjqkqrrmgmtgsjn	nlkuuifntimlplll
mfjukqrrmgutoskr	uilqlqirtgtgopkk
fjnimjpituinpflg	oosjfrighrfnttjk
fjnmmjpituqnhfmk	nkptgqsslttjmpig
okhgjprnhgmqnhpj	jrlrmoruiiliiugl
okhkjprnhguqfhqf	skiikopmjsmnmgun
golkknfhpijkinsh	isuhupmipsinkklq
golgknfhpirkqnrl	lfopgnrnjtuijfrt
hkrtllrupjsnushk	uoihprqtkhsfqlrr
hkrpllrupjknmsig	lipthrtnfgfilopq
luurhrkjrqqkjloh	oiruqtnthofrtflf
luunhrkjrqikrlnl	shrufpokfifqtinq
ljonmrpllfololti	flnpfgmuhsiufuih
ljormrpllfglglum	ignjmqltoirsjshn
ogtsisssoglkrkfq	isisjhflushruplf
ogtoisssogtkjkgu	quptgsmposurkpts
msojptpjlfguifhu	rhkojpfhogifghmn
msofptpjlfouqfiq	skonsrmgnptgfojj
nrjnplqmmtnnkjfu	opmpppurnhilnqtu
nrjrplqmmtfnsjgq	otflgjujilghnlij
loqqkugjstljqiru	trtnfkqjiqggkhhs
loqukugjsttjiisq	nfrlmoqssmtpiruk
uflkhhsiqusqhlri	skghfijnkqnsliht
uflghhsiqukqplsm	qopgpjqgikilflts
pjputfhtujtljkmr	mkrkmijmistgnuio
pjpqtfhtujllrkln	lqisupphrquohhuo
llqgiloqqilghnmh	fltkprgqpmqkkkqi
llqkiloqqitgpnll	hnjmprrttmnukhsp
kskhgoisrrinnglm	flflfltnophrhflt
ksklgoisrrqnfgmi	gqsurfkpmnkpfrit
qqunuqnnoqomhgls	imftqisfqijumhjp
qquruqnnoqgmpgmo	nmhjmrnlkrjqnlnj
umhroqsjismtntfh	fugkhfmtgmfgojkq
umhnoqsjisutftgl	lqnmthllmrkppoig
mjnmfrolgoolpkpt	mqnkkjilfoijsrkt
mjnifrolgoglhkqp	osgjhqumhrmtnqgk
rgktlnmrifijuuqn	pusplknfinigmhup
rgkplnmrifqjmupr	stqlppnunlikjotq
hmplmhotjshktlok	ngkugpsnnflkuksm
hmphmhotjspkllng	rghnpnhuopqhtksf
ggsfpoluujshuosq	njslfuimuihulsut
ggsjpoluujkhmoru	glosuioiijqrpmlr
hhknouphkrujlhfl	ftkggoqrrutsmqit
hhkrouphkrmjthgh	ooknpiltoqjjtugn
ognslrjgslngrnnp	uuqpkpjsoffpjlpk
ognolrjgslfgjnot	milfsrpmmtorhfhu
omnhstjuhsnnrjsn	fsmhufpfqhoklrjh
omnlstjuhsfnjjrr	pthfqosgojgoismh
usnggsogkkurlmto	jiftfjgurhmmlqfp
usnkgsogkkmrtmus	skfmpnqtrrgugnqp
kmggrqnnipiqqsru	hhrjugngmrrihfqf
kmgkrqnnipqqissq	ifquthgpqlgoojtl
rugoqqngiqflsppm	mpnthopqkhjkotts
rugsqqngiqnlkpqi	hjlmkittiuqppkrl
nqfgpuoflgolkpnj	iimflprnrtkurnfu
nqfkpuoflgglspof	kkqlqnmotlgupkrq
lksjusqniiomiifk	gfhqkjmgrsmlqikr
lksfusqniigmqigg	lfuhfqjkmnuknslq
pfhpstgprqiloloq	jrrrjjfljnflmmji
pfhtstgprqqlglnu	jkkiopgfukirigml
mojllilursgtgqtj	gnoihjnrmllnjfij
mojhlilursotoquf	mtruortkliqhotlg
fmrpltlmikmmtols	koqnkujfffopsnrp
fmrtltlmikumlomo	huflsnllkkhkrktf
orshqrosqrkqtspf	qsqgjtsigjkosrkr
orslqrosqrsqlsqj	piskmuhooqsspquk
oiurroqhqphijsto	rupjmnmtmslmpost
oiunroqhqppirsus	oiokmfjpjjqtopnh
omhillkrpkptlrol	qhjsprmjtmjplsqm
omhmllkrpkhttrnh	fuoitoftkmgnnimp
